a	a
abandon	abandon
abandonment	abandonment
ability	abilité
able	ábel
abnormal	abnormal
abnormality	abnormalité
aboard	aboʷrd
abolish	abolix
abolition	abolision
abolitionist	abolisionist
abort	abort
abortion	aborsion
about	abqʷt
above	abuv
abroad	abråd
absence	absens
absent	absent
absolute	absolút
absorb	abzorb
absorption	abzorpsion
abstract	abstrakt
abstraction	abstraksion
absurd	absurd
absurdity	absurdité
abundance	abundans
abundant	abundant
abuse	abús
abuse v	abúz
academia	akadémia
academic	akademik
academy	akademé
accelerate	akselerát
acceleration	akselerásion
accent	aksent
accentuate	aksentúát
accept	aksept
acceptance	akseptans
access	akses
accessible	aksesabel
accessory	aksesoré
accident	aksident
accidental	aksidental
accommodate	akomodát
accommodation	akomodásion
accompaniment	akumpanément
accompany	akumpané
accomplish	akomplix
accomplishment	akomplixment
accord	akord
accordance	akordans
account	akq́nt
accountability	akq́ntabilité
accountant	akq́ntant
accumulate	akúmúlát
accumulation	akúmúlásion
accuracy	akúrasé
accurate	akúrat
accusation	akúzásion
accuse	akúz
achieve	acév
achievement	acévment
acid	asid
acknowledge	aknolej
acquire	akwír
acquisition	akwizision
acre	áker
across	akros
act	akt
action	aksion
activate	aktivát
activation	aktivásion
activator	aktivátor
active	aktiv
activism	aktivizem
activist	aktivist
activity	aktivité
actor	aktor
actress	aktres
actual	aktúal
actuality	aktúalité
acute	akút
ad	ad
adapt	adapt
adaptation	adaptásion
add	ad
addiction	adiksion
addictive	adiktiv
addition	adision
additional	adisional
address	adres
adequate	adekwat
adhere	adhér
adjacent	ajásent
adjective	ajektiv
adjust	ajust
adjustment	ajustment
administer	administer
administrate	administrát
administration	administrásion
administrative	administrátiv
administrator	administrátor
admire	admír
admission	admision
admit	admit
adolescent	adolesent
adopt	adopt
adoption	adopsion
adult	adult
advance	advans
advancement	advansment
advantage	advantaj
advantageous	advantájos
adventure	adventúr
adventurous	adnventúros
adverb	adverb
adverbial	adverbial
adverse	advers
advertise	advertíz
advertisement	advertizment
advice	advís
advise	advíz
advocacy	advokasé
advocate	advokát
aesthetic	esþetik
affair	afár
affect	afekt
affection	afeksion
affectionate	afeksionat
afford	aford
afraid	afraʸd
after	after
aftermath	aftermaþ
afternoon	afternq̇n
afterthought	afterþåt
again	agaʸn
against	agaʸnst
age	aʸj
agency	ajensé
agenda	ajenda
agent	ájent
aggression	agresion
aggressive	agresiv
aggressor	agresor
ago	agoʷ
agree	agré
agreement	agrément
agricultural	agrikultúral
agriculture	agrikultúr
ah	a
ahead	ahed
aid	aʸd
aide	aʸd
aim	aʸm
air	aʸr
aircraft	aʸrkraft
airline	aʸrliʸn
airman	aʸrman
airplane	aʸrplaʸn
airport	aʸrport
airspace	aʸrspaʸs
airstrip	aʸrstrip
airwave	aʸrʷaʸv
alarm	alarm
albeit	ålbeʸit
album	album
alcohol	alkohol
alcoholic	alkoholik
alert	alert
algebra	aljebra
alien	álien
alienate	álienát
align	alín
alignment	alínment
alike	aliʸk
alive	aliʸv
all	ål
allegation	alagásion
allege	alej
alliance	alíans
allocate	alokát
allocation	alokásion
allow	alqʷ
allowance	alqʷans
ally	alí
almost	ålmoʷst
alone	aloʷn
along	aloŋ
alongside	aloŋsiʸd
already	ålredé
alright	ålriʸt
also	ålsoʷ
alter	olter
alternate	olternát
alternation	olternásion
alternative	olternativ
alternator	olternátor
although	ålðoʷ
altogether	åltqgeðer
aluminium	alúminium
always	ålwaʸz
am	am
amateur	amatúr
ambassador	ambasador
ambition	ambision
ambitious	ambisios
ambulance	ambúlans
amend	amend
amendment	amendment
amid	amid
ammonia	amónia
among	amuŋ
amount	amq́nt
amplitude	amplitúd
amuse	amúz
amusement	amúzment
an	an
analogous	analogos
analogue	analog
analogy	analojé
analyse	analíz
analysis	analisis
analyst	analist
analytic	analitik
analytical	analitikal
analyze	analíz
anarchist	anarkist
anarchy	anarké
anatomical	anatomikal
anatomy	anatomé
ancestor	ansestor
ancestral	ansestral
ancestry	ansestré
anchor	aŋkor
ancient	ánsient
and	and
angel	ánjel
anger	aŋger
angle	aŋgel
angry	aŋgeré
angst	aŋst
angular	aŋgúlar
animal	animal
animate	animát
animation	animásion
animator	animátor
anime	animaʸ
ankle	aŋkel
anniversary	aniversaré
announce	anq́ns
announcement	anq́nsment
annoy	anoʸ
annoyance	anoʸans
annual	anúal
anonymity	anonimité
anonymous	anonimos
another	anuðer
answer	anser
ant	ant
anticipate	antisipát
anticipation	antisipásion
anxiety	aŋzíeté
anxious	aŋksios
any	ané
anybody	anébodé
anyhow	anéhqʷ
anymore	anémoʷr
anyone	anéwun
anything	anéþiŋ
anytime	anétiʸm
anyway	anéwaʸ
anywhere	anéhwaʸr
apart	apart
apartment	apartment
apologetic	apolojetik
apologise	apolojíz
apologist	apolojist
apologize	apolojíz
apology	apolojé
apostrophe	apostrofé
app	ap
apparatus	aparatus
apparent	aparent
appeal	apél
appear	apér
appearance	apérans
appendage	apendaj
appendices	apendiséz
appendix	apendiks
appetise	apetíz
appetite	apetít
appetize	apetíz
applaud	aplåd
apple	apel
applicable	aplikabel
applicant	aplikant
application	aplikásion
apply	aplí
appoint	apoʸnt
appointment	apoʸntment
appreciate	aprésiát
appreciation	aprésiásion
appreciative	aprésiativ
approach	apróc
appropriate	aprópriat
appropriate v	aprópriát
appropriation	aprópriásion
approval	aprq̇val
approve	aprq̇v
approximate	aproksimat
approximate v	aproksimát
approximation	aproksimásion
april	ápril
arbitrary	arbitraré
arbitrate	arbitrát
arbitration	arbitrásion
arbitrator	arbitrátor
arc	ark
arch	arc
architect	arkitekt
architectural	arkitektúral
architecture	arkitektúr
archival	arkíval
archive	arkív
archivist	arkivist
arctic	arktik
are	ar
area	aréa
arena	aréna
aren't	arnt
argue	argú
argument	argúment
argumentation	argúmentásion
arise	ariʸz
arisen	arizen
arithmetic	ariþmetik
arm	arm
army	armé
arose	aroʷz
around	aroʷnd
arousal	arq́zal
arouse	arq́z
arrange	aránj
arrangement	aránjment
array	araʸ
arrest	arest
arrival	aríval
arrive	arív
arrow	aró
art	art
article	artikel
articulate	artikúlát
articulation	artikúlásion
artificial	artifisial
artist	artist
artistic	artistik
artistry	artistré
artwork	artʷurk
as	az
asbestos	asbestos
ash	ax
aside	asiʸd
ask	ask
asleep	asleʸp
aspect	aspekt
aspiration	aspirásion
aspire	aspír
assassin	asasin
assassinate	asasinát
assassination	asasinásion
assault	asålt
assemblage	asemblaj
assemble	asembel
assembly	asembelé
assert	asert
assertion	asersion
assertive	asertiv
assess	ases
assessment	asesment
assessor	asesor
asset	aset
assign	asín
assignment	asínment
assist	asist
assistance	asistans
assistant	asistant
assistive	asistiv
associate	asósiat
associate v	asósiát
association	asosiásion
associative	asósiativ
assume	asúm
assumption	asumsion
assurance	axúrans
assure	axúr
asylum	asílum
at	at
ate	aʸt
athlete	aþlét
athletic	aþletik
atmosphere	atmosfér
atmospheric	atmosferik
atrocity	atrosité
attach	atac
attachment	atacment
attack	atak
attain	atán
attainment	atánment
attempt	atemt
attend	atend
attendance	atendans
attendant	atendant
attendee	atendé
attention	atension
attitude	atitúd
attorney	aturné
attract	atrakt
attraction	atraksion
attractive	atraktiv
attractor	atraktor
attribute	atribút
attribution	atribúsion
attributive	atribútiv
auction	åksion
audience	ådiens
audio	ådió
audit	ådit
audition	ådision
auditor	åditor
auditory	åditoré
august	ågust
aunt	ant
auntie	anté
aunty	anté
authentic	åþentik
authenticate	åþentikát
authentication	åþentikásion
authenticity	åþentisité
author	åþor
authorisation	åþorizásion
authorise	åþoríz
authoritarian	åþoritárian
authoritative	åþoritátiv
authority	åþorité
authorization	åþorizásion
authorize	åþoríz
authorship	åþorxip
autism	åtizem
autistic	åtistik
auto	åtó
automate	åtomát
automatic	åtomatik
automation	åtomásion
automaton	åtomaton
automobile	åtomobél
automotive	åtomótiv
autonomous	åtonomos
autonomy	åtonomé
autumn	åtum
average	averaj
avoid	avoʸd
avoidance	avoʸdans
await	awaʸt
awake	awaʸk
awaken	awaʸken
award	aword
aware	awaʸr
away	awaʸ
awe	å
awesome	åsum
awful	åfql
awhile	ahwiʸl
awkward	åkword
awoke	awoʷk
awoken	awoʷken
axis	aksis
baby	bábé
back	bak
backbone	bakboʷn
backdrop	bakdrop
background	bakgrqʷnd
backup	bakup
bad	bad
baddy	badé
badge	baj
bag	bag
bail	baʸl
bake	baʸk
bakery	baʸkeré
balance	balans
balcony	balkoné
bald	båld
bale	baʸl
ball	bål
ballet	balaʸ
balloon	balq̇n
ballot	balot
ban	ban
banana	banana
band	band
bang	baŋ
bank	baŋk
bankrupt	baŋkrupt
bankruptcy	baŋrupsé
banner	baner
bar	bar
bare	baʸr
barefoot	baʸrfqt
bargain	bargan
bark	bark
barrel	barel
barrier	barier
base	baʸs
baseball	baʸsbål
basement	baʸsment
basic	baʸsik
basin	básin
basis	básis
basket	basket
basketball	basketbål
bass	bas
bass 2	baʸs
bat	bat
bath	baþ
bathe	baʸð
bathroom	baþrq̇m
bathtub	baþtub
battery	bateré
battle	batel
battlefield	batelfeʸld
battleground	batelgrqʷnd
bay	baʸ
be	beʸ
beach	beʸc
beak	beʸk
beaker	beʸker
beam	beʸm
bean	beʸn
bear	baʸr
beard	beʸrd
beast	beʸst
beat	beʸt
beaten	beʸten
beautiful	bútefql
beautify	bútefí
beauty	búté
became	bekaʸm
because	bekåz
become	bekum
bed	bed
bedroom	bedrq̇m
bee	beʸ
beef	beʸf
been	beʸn
beer	beʸr
before	befoʷr
beforehand	befoʷrhand
beg	beg
began	began
begin	begin
begun	begun
behalf	behaf
behave	beháv
behavior	behávior
behavioral	behávioral
behaviour	behávior
behavioural	behávioral
behind	behiʸnd
behold	behoʷld
belief	beleʸf
believe	beleʸv
bell	bel
belong	beloŋ
below	beloʷ
belt	belt
bench	benc
benchmark	bencmark
bend	bend
beneath	beneʸþ
beneficial	benefisial
beneficiary	benefisiaré
benefit	benefit
bent	bent
berry	beré
beside	besiʸd
best	best
bet	bet
betray	betraʸ
betrayal	betraʸal
better	beter
between	betweʸn
beyond	beyond
bias	bías
bible	bíbel
biblical	biblikal
bibliography	bibliografé
bicycle	bísikel
bid	bid
bide	biʸd
big	big
bike	biʸk
bill	bil
billion	bilion
billionaire	bilionár
bin	bin
binary	bínaré
bind	biʸnd
biography	bíografé
biological	bíolojikal
biologist	bíolojist
biology	bíolojé
bird	bird
birth	birþ
birthday	birþdaʸ
birthmark	birþmark
birthplace	birþplaʸs
biscuit	biskut
bisexual	bíseksúal
bishop	bixop
bit	bit
bite	biʸt
bitten	biten
bitter	biter
bizarre	bizar
black	blak
blackberry	blakberé
blackbird	blakbird
blackboard	blakboʷrd
blade	blaʸd
blame	blaʸm
blank	blaŋk
blanket	blaŋket
blast	blast
bled	bled
bleed	bleʸd
blend	blend
bless	bles
blew	bluʷ
blind	bliʸnd
blindfold	bliʸndfoʷld
block	blok
blockade	blokád
blockage	blokaj
blog	blog
bloke	bloʷk
blond	blond
blonde	blond
blood	blud
bloodhound	bludhqʷnd
blouse	blqʷs
blow	bloʷ
blown	bloʷn
blue	bluʷ
bluebell	bluʷbel
blueberry	bluʷberé
bluebird	bluʷbird
bluegrass	bluʷgras
blueprint	bluʷprint
bluetooth	bluʷtq̇þ
board	boʷrd
boardroom	boʷrdrq̇m
boast	boʷst
boat	boʷt
body	bodé
bodyguard	bodégard
boil	boʸl
bold	boʷld
bomb	bom
bombard	bombard
bombardment	bombardment
bond	bond
bondage	bondaj
bone	boʷn
bonus	bónus
book	bqk
bookcase	bqkkaʸs
bookshelf	bqkxelf
bookshelve	bqkxelv
bookstore	bqkstoʷr
bookworm	bqkwurm
boom	bq̇m
boost	bq̇st
boot	bq̇t
border	border
bore	boʷr
boredom	boʷrdom
born	boʷrn
borne	boʷrn
borrow	boró
boss	bos
both	boʷþ
bother	boðer
bottle	botel
bottom	botom
bought	båt
bounce	bqʷns
bound	bqʷnd
boundary	bq́ndaré
bow	boʷ
bow 2	bqʷ
bowl	boʷl
box	boks
boy	boʸ
boyfriend	boʸfrend
brain	braʸn
brainstorm	braʸnstorm
brainwash	braʸnwox
brainwave	braʸnwaʸv
brake	braʸk
branch	branc
brand	brand
brass	bras
brave	braʸv
bravery	bráveré
breach	breʸc
bread	bred
break	braʸk
breakage	braʸkaj
breakaway	braʸkawaʸ
breakdown	braʸkdqʷn
breakfast	brekfast
breakthrough	braʸkþrq̇
breakup	braʸkup
breast	brest
breastfed	brestfed
breastfeed	brestfeʸd
breath	breþ
breathe	breʸð
bred	bred
breed	breʸd
brick	brik
bride	briʸd
bridge	brij
brief	breʸf
bright	briʸt
brilliant	briliant
bring	briŋ
broad	bråd
broadband	brådband
broadcast	brådkast
broke	broʷk
broken	broʷken
broker	bróker
brother	bruðer
brotherhood	bruðerhqd
brought	bråt
brown	brqʷn
browse	brqʷz
brush	brux
brutal	brútal
brutalise	brútalíz
brutality	brútalité
brutalize	brútalíz
brute	bruʷt
bubble	bubel
buck	buk
bucket	buket
bud	bud
buddy	budé
budget	bujet
buffer	bufer
bug	bug
build	bild
built	bilt
bulb	bulb
bulk	bulk
bulky	bulké
bullet	bqlet
bunch	bunc
burden	burden
burdensome	burdensum
bureaucracy	búrokrasé
burial	berial
burn	burn
burnt	burnt
burst	burst
bury	beré
bus	bus
bush	bqx
business	biznes
businessman	biznesman
busy	bizé
but	but
butter	buter
buttercup	buterkup
butterfly	buterfliʸ
buttock	butok
button	buton
buy	biʸ
by	biʸ
bye	biʸ
cabin	kabin
cabinet	kabinet
cable	kábel
cafe	kafaʸ
cake	kaʸk
calculate	kalkúlát
calculation	kalkúlásion
calculator	kalkúlátor
calendar	kalendar
call	kål
calm	kalm
came	kaʸm
camera	kamera
camp	kamp
campaign	kampán
campus	kampus
can	kan
canal	kanal
cancel	kansel
cancelation	kanselásion
cancellation	kanselásion
cancer	kanser
cancerous	kanseros
candid	kandid
candidacy	kandidasé
candidate	kandidat
candle	kandel
candor	kandor
candy	kandé
cane	kaʸn
canine	kánín
cannibal	kanibal
cannibalise	kanibalíz
cannibalize	kanibalíz
cannon	kanon
cannonball	kanonbål
cannot	kanot
canon	kanon
canonical	kanonikal
canonise	kanoníz
canonize	kanoníz
cant	kant
can't	kant
canvas	kanvas
cap	kap
capability	kápabilité
capable	kápabel
capacity	kapasité
capital	kapital
capitalise	kapitalíz
capitalism	kapitalizem
capitalist	kapitalist
capitalization	kapitalizásion
capitalize	kapitalíz
capitol	kapitol
captain	kaptan
capture	kaptúr
car	kar
carb	karb
carbohydrate	karbóhídrát
carbon	karbon
carbonate	karbonát
card	kard
cardboard	kardboʷrd
care	kaʸr
career	karér
careful	kaʸrfql
caregiver	kaʸrgiver
caretaker	kaʸrtaʸker
cargo	kargó
carpet	karpet
carriage	karaj
carrot	karot
carry	karé
cart	kart
cartilage	kartilaj
cartoon	kartq̇n
cartoonist	kartq̇nist
carve	karv
case	kaʸs
cash	kax
casino	kasénó
cast	kast
castle	kasel
casual	kazúal
casualty	kazúalté
cat	kat
catalogue	katalog
catarrh	katar
catch	kac
catchy	kacé
categorical	kategorikal
categorisation	kategorizásion
categorise	kategoríz
categorization	kategorizásion
categorize	kategoríz
category	kategoré
cater	káter
cattle	katel
caught	kåt
cause	kåz
caution	kåsion
cautionary	kåsionaré
cautious	kåsios
cave	kaʸv
cavity	kavité
cease	seʸs
ceasefire	seʸsfiʸr
ceiling	séliŋ
celebrate	selebrát
celebration	selebrásion
celebrity	selebrité
cell	sel
cellar	selar
cellphone	selfoʷn
cellular	selúlar
cemetery	semeteré
cent	sent
centenarian	sentenarian
centennial	sentenial
center	senter
central	sentral
centralise	sentralíz
centrality	sentralité
centralization	sentralizásion
centralize	sentralíz
centre	senter
century	sentúré
ceremonial	seremónial
ceremony	seremóné
certain	sertan
certainty	sertanté
certificate	sertificat
certification	sertifikásion
certify	sertifí
chain	caʸn
chair	caʸr
chairman	caʸrman
chairmanship	caʸrmanxip
chairperson	caʸrperson
chalk	cåk
challenge	calenj
chamber	cámber
champagne	xampán
champion	campion
championship	campionxip
chance	cans
change	caʸnj
changeling	caʸnjliŋ
channel	canel
chaos	káos
chaotic	káotik
chapter	capter
character	karakter
characterisation	karakterizásion
characterise	karakteríz
characteristic	karakteristik
characterization	karakterizásion
characterize	karakteríz
charge	carj
charity	carité
charm	carm
chart	cart
charter	carter
chase	caʸs
chat	cat
chauffeur	xófer
cheap	ceʸp
cheapen	ceʸpen
cheat	ceʸt
check	cek
cheek	ceʸk
cheekbone	ceʸkboʷn
cheeky	ceʸké
cheer	ceʸr
cheerful	ceʸrfql
cheerlead	ceʸrleʸd
cheery	ceʸré
cheese	ceʸz
cheesecake	ceʸzkaʸk
cheesy	ceʸzé
chef	xef
chemical	kemikal
chemist	kemist
chemistry	kemistré
chest	cest
chicken	ciken
chief	ceʸf
child	ciʸld
childbearing	ciʸldbaʸriŋ
childbirth	ciʸldbirþ
childcare	ciʸldkaʸr
childhood	ciʸldhqd
childish	ciʸldix
children	cildren
chimney	cimné
chin	cin
china	cína
chinatown	cínatqʷn
chinese	cínéz
chip	cip
chocolate	cokolat
choice	cois
choir	kwiʸr
choirboy	kwiʸrboʸ
choose	cuʷz
chop	cop
chorus	kórus
chose	coʷz
chosen	coʷzen
chronic	kronik
chronicle	kronikel
chunk	cuŋk
church	curc
churchyard	curcyard
cigar	sigar
cigarette	sigaret
cinema	sinema
cinematic	sinematik
cinnamon	sinamon
circle	sirkel
circuit	sirkut
circuitry	sirkutré
circular	sirkúlar
circulate	sirkúlát
circulation	sirkúlásion
circulatory	sirkúlatoré
circumcise	sirkumsíz
circumcision	sirkumsizion
circumference	sirkumferens
circumnavigate	sirkumnavigát
circumscribe	sirkumskríb
circumstance	sirkumstans
circumvent	sirkumvent
circus	sirkus
cis	sis
cite	siʸt
citizen	sitizen
citizenry	sitizenré
citizenship	sitizenxip
citrus	sitrus
city	sité
civic	sivik
civil	sivil
civilian	sivilian
civilisation	sivilizásion
civilise	sivilíz
civility	sivilité
civilization	sivilizásion
claim	klaʸm
claimant	klaʸmant
clarification	klarifikásion
clarify	klarifí
clarity	klarité
clash	klax
class	klas
classic	klasik
classical	klasikal
classicist	klasisist
classification	klasifikásion
classify	klasifí
classroom	klasrq̇m
clause	klåz
claw	klå
clay	klaʸ
clean	kleʸn
cleanse	klenz
clear	kleʸr
cleavage	kleʸvaj
clerk	klerk
clever	klever
click	klik
client	klíent
clientele	klíentel
cliff	klif
climate	klímat
climb	kliʸm
climber	kliʸmer
cling	kliŋ
clinic	klinik
clinical	klinikal
clinician	klinisian
clip	klip
clock	klok
clockwise	klokwiʸz
clockwork	klokwurk
close	kloʷs
close v	kloʷz
closure	klózúr
cloth	kloþ
clothe	kloʷð
clothier	kloʷðier
clothing	kloʷðiŋ
cloud	klqʷd
cloudy	klqʷdé
club	klub
clubhouse	klubhqʷs
clue	kluʷ
clung	kluŋ
cluster	kluster
coach	koʷc
coal	koʷl
coalesce	kóales
coalition	kóalision
coast	koʷst
coastal	koʷstal
coastguard	koʷstgard
coastline	koʷstliʸn
coat	koʷt
cocktail	koktál
code	koʷd
codify	kodifí
coffee	kofé
cognition	kognision
cognitive	kognitiv
coil	koʸl
coin	koʸn
coinage	koʸnaj
coincide	kóinsíd
coincidence	kóinsidens
cold	koʷld
collaborate	kolaborát
collaboration	kolaborásion
collaborative	kolaborativ
collaborator	kolaborátor
collapse	kolaps
collar	kolar
colleague	kolég
collect	kolekt
collectible	kolektibel
collection	koleksion
collective	kolektiv
collectivity	kolektivité
collector	kolektor
college	kolej
collide	kolíd
collision	kolizion
colonel	kuronel
colonial	kolónial
colonialism	kolónializem
colonise	koloníz
colonist	kolonist
colonization	kolonizásion
colonize	koloníz
colony	koloné
color	kulor
colour	kulor
colourful	kulorfql
column	kolum
columnist	kolumnist
comb	koʷm
combat	kombat
combatant	kombatant
combination	kombinásion
combine	kombín
come	kum
comedy	komedé
comfort	kumfort
comfortable	kumfortabel
comic	komik
command	komand
commandeer	komandér
commandment	komandment
commence	komens
commencement	komensment
comment	koment
commentary	komentaré
commentator	komentátor
commerce	komers
commercial	komersial
commercialise	komersialíz
commercialization	komersializásion
commercialize	komersialíz
commission	komision
commissioner	komisioner
commit	komit
commitment	komitment
committal	komital
committee	komité
commodity	komodité
common	komon
communicate	komúnikát
communication	komúnikásion
communicative	komúnikativ
communicator	komúnikátor
communist	komúnist
community	komúnité
companion	kompanion
companionship	kompanionxip
company	kompané
comparable	komparabel
comparative	komparativ
compare	kompár
comparison	komparison
compassion	kompasion
compassionate	kompasionat
compel	kompel
compensate	kompensát
compensation	kompensásion
compete	kompét
competence	kompetens
competent	kompetent
competition	kompetision
competitive	kompetitiv
competitor	kompetitor
compilation	kompilásion
compile	kompíl
complain	komplán
complaint	komplánt
complement	komplement
complete	komplét
completion	komplésion
complex	kompleks
complexion	kompleksion
complexity	kompleksité
compliance	komplíans
compliant	komplíant
complicate	komplikát
complication	komplikásion
comply	komplí
component	kompónent
compose	kompóz
composite	kompozit
composition	kompozision
compound	kompq́nd
comprehend	komprehend
comprehension	komprehension
comprehensive	komprehensiv
comprise	kompríz
compromise	kompromíz
compulsory	kompulsoré
computation	kompútásion
computational	kompútásional
compute	kompút
computerise	kompúteríz
computerize	kompúteríz
conceal	konsél
concede	konséd
conceit	konsét
conceive	konsév
concentrate	konsentrát
concentration	konsentrásion
concentrator	konsentrátor
concept	konsept
conception	konsepsion
conceptual	konseptúal
conceptualise	konseptúalíz
conceptualization	konseptúalizásion
conceptualize	konseptúalíz
concern	konsern
concert	konsert
concession	konsesion
concise	konsís
conclude	konklúd
conclusion	konklúzion
conclusive	konklúsiv
concrete	konkrét
condemn	kondem
condemnation	kondemnásion
condition	kondision
conditional	kondisional
conduct	kondukt
conduction	konduksion
conductor	konduktor
confer	konfer
conference	konferens
confess	konfes
confession	konfesion
confessional	konfesional
confessor	konfesor
confidant	konfidant
confide	konfíd
confidence	konfidens
confident	konfident
confidential	konfidensial
confidentiality	konfidensialité
configuration	konfigúrásion
configure	konfigúr
confine	konfín
confirm	konfirm
confirmation	konfirmásion
conflict	konflikt
confront	konfrunt
confrontation	confruntásion
confuse	konfúz
confusion	konfúzion
congrats	kongrats
congratulate	kongratúlát
congratulation	kongratúlásion
congregation	kongregásion
congress	kongres
congressional	kongresional
congressman	kongresman
connect	konekt
connection	kokeksion
conquer	koŋker
conqueror	koŋkeror
conscience	konsiens
conscientious	konsiensios
conscious	konsios
consecutive	konsekútiv
consensual	konsensúal
consensus	konsensus
consent	konsent
consequence	konsekwens
consequential	konsekwensial
conservation	konservásion
conservative	konservativ
conservator	konservator
conservatory	konservatoré
conserve	konserv
consider	konsider
considerate	konsiderat
consideration	konsiderásion
consignment	konsínment
consist	konsist
consistency	konsistensé
consistent	konsistent
consolidate	konsolidát
consolidation	konsolidásion
conspiracy	konspirasé
conspire	konspír
constant	konstant
constituency	konstitúensé
constituent	konstitúent
constitute	konstitút
constitution	konstitúsion
constitutional	konstitúsional
constitutionalist	konstitúsionalist
constitutionality	konstitúsionalité
constrain	konstrán
constraint	konstránt
construct	konstrukt
construction	konstruksion
constructive	konstruktiv
constructor	konstruktor
consult	konsult
consultant	konsultant
consultation	konsultásion
consume	konsúm
consumerism	konsúmerizem
consumption	konsumsion
contact	kontakt
contain	kontán
containment	kontánment
contemplate	kontemplát
contemplation	kontemplásion
contemplative	kontemplativ
contemporary	kontemporaré
contempt	kontemt
contend	kontend
contender	kontender
content	kontent
contention	kontension
contentious	kontensios
contentment	kontentment
contest	kontest
contestant	kontestant
context	kontekst
contextual	kontekstúal
contextualize	kontekstúalíz
continent	kontinent
continental	kontinental
continual	kontinúal
continuation	kontinúásion
continue	kontinú
continuity	kontinúité
continuous	kontinúos
continuum	kontinúum
contour	kontq̇r
contract	kontrakt
contractor	kontraktor
contradict	kontradikt
contradiction	kontradiksion
contradictory	kontradiktoré
contrary	kontraré
contrast	kontrast
contribute	kontribút
contribution	kontribúsion
contributor	kontribútor
control	kontról
controversial	kontroversial
controversy	kontroversé
convenience	konvéniens
convenient	konvénient
convention	konvension
conventional	konvensional
conversation	konversásion
conversational	konversásional
conversationalist	konversásionalist
converse	konvers
conversion	konverzion
convert	konvert
convertible	konvertibel
convey	konvaʸ
conveyance	konvaʸans
conveyor	konvaʸor
convict	konvikt
conviction	konviksion
convince	konvins
cook	kqk
cookbook	kqkbqk
cooker	kqker
cookie	kqké
cool	kq̇l
cooperate	kóoperát
cooperation	kóoperásion
cooperative	kóoperativ
cooperator	kóoperátor
coordinate	kóordinát
coordination	kóordinásion
coordinator	kóordinátor
cop	kop
cope	koʷp
copper	koper
copy	kopé
copyright	kopériʸt
cord	kord
core	koʷr
cork	kork
corner	korner
cornerstone	kornerstoʷn
corporate	korporat
corporation	korporásion
correct	korekt
correction	koreksion
correctional	koreksional
corrective	korektiv
correlate	korelát
correlation	korelásion
correspond	korespond
correspondence	korespondens
correspondent	korespondent
corridor	koridor
corrode	koród
corrosion	korózion
corrupt	korupt
corruption	korupsion
cost	kost
costume	kostúm
cottage	kotaj
cotton	koton
cough	kof
could	kqd
couldn't	kqdnt
council	kq́nsil
councillor	kq́nsilor
counsel	kq́nsel
counsellor	kq́nselor
count	kqʷnt
countdown	kqʷntdqʷn
counter	kqʷnter
counterpart	kq́nterpart
country	kuntré
countryman	kuntréman
countryside	kuntrésiʸd
county	kq́nté
coup	kq̇
coupe	kq̇p
couple	kupel
courage	kuraj
courageous	kurájos
course	koʷrs
coursebook	koʷrsbqk
coursework	koʷrswurk
court	koʷrt
courteous	kurtéos
courtesy	kurtesé
cousin	kuzin
cover	kuver
coverage	kuveraj
cow	kqʷ
cowbell	kqʷbel
crack	krak
crackdown	krakdqʷn
craft	kraft
craftsman	kraftsman
craftsmanship	kraftsmanxip
crash	krax
crawl	krål
crazy	kraʸzé
cream	kreʸm
create	kréát
creation	kréásion
creationism	kréásionizem
creationist	kréásionist
creative	kréátiv
creativity	kréátivité
creator	kréátor
creature	kréatúr
credible	kredibel
credit	kredit
creep	kreʸp
crept	krept
crew	kruʷ
crewman	kruʷman
crime	kriʸm
criminal	kriminal
criminalise	kriminalíz
criminality	kriminalité
criminalize	kriminalíz
criminologist	kriminolojist
criminology	kriminolojé
crisis	krísis
criterion	krítérion
critic	kritik
critical	kritikal
criticise	kritisíze
criticism	kritisizem
criticize	kritisíz
critique	kriték
crop	krop
cross	kros
crossbow	krosboʷ
crossroad	krosroʷd
crossword	kroswurd
crow	kroʷ
crowd	krqʷd
crown	krqʷn
crucial	krúsial
crucifix	krúsifiks
crucifixion	krúsifiksion
crucify	krúsifí
crude	kruʷd
crudity	krúdité
cruel	krúel
cruelty	krúelté
cruise	kruʷz
crush	krux
cry	kriʸ
crystal	kristal
crystalline	kristalin
crystallise	kristalíz
crystallize	kristalíz
cue	kuʷ
cult	kult
cultivate	kultivát
cultivation	kultivásion
cultivator	kultivátor
cultural	kultúral
culture	kultúr
cup	kup
cupboard	kubord
cure	kuʷr
curiosity	kúriosité
curious	kúrios
curly	kurlé
currency	kurensé
current	kurent
curriculum	kurikúlum
curtain	kurtan
curve	kurv
cushion	kusion
cusp	kusp
custody	kustodé
custom	kustom
customary	kustomaré
customer	kustomer
customise	kustomíz
customization	kustomizásion
customize	kustomíz
cut	kut
cutaway	kutaʷaʸ
cutback	kutbak
cute	kuʷt
cycle	síkel
cyclic	siklik
cyclical	siklikal
cyclist	síkelist
cynic	sinik
cynical	sinikal
dad	dad
daddy	dadé
daily	daʸlé
dairy	dáré
dam	dam
damage	damaj
dance	dans
danger	dánjer
dangerous	dánjeros
dare	daʸr
dark	dark
darken	darken
data	dáta
database	dátabaʸs
date	daʸt
daughter	dåter
dawn	dån
day	daʸ
daycare	daʸkaʸr
daydream	daʸdreʸm
daylight	daʸliʸt
daytime	daʸtiʸm
dead	ded
deaden	deden
deadline	dedliʸn
deadly	dedlé
deaf	def
deafen	defen
deal	deʸl
dealer	deʸler
dealership	deʸlerxip
dealt	delt
dear	deʸr
death	deþ
debate	debát
debit	debit
debris	debré
debt	det
debtor	detor
debut	debú
decade	dekád
december	desember
decency	désensé
decent	désent
decide	desíd
decision	desizion
decisionmake	desizionmaʸk
decisive	desísiv
deck	dek
declaration	deklarásion
declarative	deklárativ
declare	deklár
decline	deklín
decorate	dekorát
decoration	dekorásion
decorative	dekorativ
decorator	dekorátor
decrease	dékrés
dedicate	dedikát
dedication	dedikásion
deed	deʸd
deem	deʸm
deep	deʸp
deepen	deʸpen
default	defålt
defeat	defét
defect	défekt
defect v	defekt
defection	defeksion
defective	defektiv
defector	defektor
defence	defens
defend	defend
defendant	defendant
defender	defender
defense	defens
defensible	defensibel
defensive	defensiv
defiance	defíans
defiant	defíant
deficiency	defisiensé
deficient	defisient
deficit	defisit
define	defín
definite	definit
definition	definision
definitive	definitiv
deflate	deflát
deflation	deflásion
defy	defí
degenerate	dejenerat
degenerative	dejenerativ
degree	degré
dehumanise	déhúmaníz
dehumanize	déhúmaníz
dehydrate	dehídrát
dehydration	dehídrásion
delay	delaʸ
delegate	delegat
delegate 2	delegát
delegation	delegásion
delete	delét
deletion	delésion
deliberate	deliberát
deliberation	deliberásion
delicacy	delikasé
delicate	delikat
delicatessen	delikatesen
delicious	delisios
delight	delít
delightful	delítfql
deliver	deliver
deliverance	deliverans
delivery	deliveré
demand	demand
democracy	demokrasé
democrat	demokrat
democratic	demokratik
democratise	demokratíz
democratization	demokratizásion
democratize	demokratíz
demon	démon
demonic	demonik
demonize	démoníz
demonstrable	demonstrabel
demonstrate	demonstrát
demonstration	demonstrásion
demonstrative	demonstrativ
demonstrator	demonstrátor
denial	deníal
denominate	denominát
denomination	denominásion
denominator	denominátor
denounce	denq́ns
dense	dens
density	densité
dental	dental
dentist	dentist
dentistry	dentistré
denture	dentúr
deny	dení
depart	depart
department	department
departmental	departmental
departure	departúr
depend	depend
dependant	dependant
dependence	dependens
dependency	dependansé
dependent	dependent
depict	depikt
depiction	depiksion
deploy	deploʸ
deployment	deploʸment
deposit	depozit
deposition	depozision
depress	depres
depression	depresion
depressive	depresiv
deprive	deprív
depth	depþ
deputise	depútíz
deputize	depútíz
deputy	depúté
derivation	derivásion
derivative	derivativ
derive	derív
descend	desend
descendant	desendant
descent	desent
describe	deskrí
description	deskripsion
descriptive	deskriptiv
descriptor	deskriptor
desert	dezert
desertion	dezersion
deserve	dezerv
design	dezín
designate	dezignát
designation	dezignásion
desire	dezír
desk	desk
desktop	desktop
desperate	desperat
desperation	desperásion
despite	despít
destination	destinásion
destined	destind
destiny	destiné
destroy	destroʸ
destruction	destruksion
destructive	destruktiv
detail	detál
detain	detán
detainee	detáné
detect	detekt
detection	deteksion
detective	detektiv
detector	detektor
detention	detension
deteriorate	detériorát
deterioration	detériorásion
determinant	determinant
determination	determinásion
determine	determin
determinism	determinizem
determinist	determinist
deterministic	deterministik
devastate	devastát
devastation	devastásion
develop	develop
development	development
developmental	developmental
device	devís
devil	devil
devise	devíz
devote	devót
dew	duʷ
diagnose	díagnós
diagnosis	díagnósis
diagnostic	díagnostik
diagonal	díagonal
diagram	díagram
dialogue	díalog
diameter	díameter
diamond	díamond
diary	díaré
dictate	diktát
dictator	diktátor
dictatorial	diktatórial
dictatorship	diktátorxip
dictionary	diksionaré
did	did
didn't	didn't
die	diʸ
diet	díet
dietary	díetaré
dietician	díetisian
dietitian	díetisian
differ	difer
difference	diferens
different	diferent
differential	diferensial
differentiate	diferensiát
differentiation	diferensiásion
difficult	difikult
difficulty	difikulté
dig	dig
digest	díjest
digestion	díjestion
digestive	díjestiv
digital	dijital
digitise	dijitíz
digitize	dijitízer
dignity	dignité
dike	diʸk
dilemma	dilema
dilute	dílút
dilution	dílúsion
dimension	dimension
dimensional	dimensional
diminish	diminix
dinner	diner
dip	dip
diploma	diplóma
diplomacy	diplómasé
diplomat	diplomat
diplomatic	diplomatik
direct	direkt
direction	direksion
directional	direksional
directive	direksion
director	direktor
directorate	direktorat
directorship	direktorxip
directory	direktoré
dirt	dirt
dirty	dirté
disability	disabilité
disable	disábel
disadvantage	disadvantaj
disagree	disagré
disagreement	disagrément
disallow	disalqʷ
disambiguate	disambigúát
disappear	disapér
disappearance	disapérans
disappoint	disapoʸnt
disappointment	disapoʸntment
disapproval	disaprq̇val
disapprove	disaprq̇v
disaster	dizaster
disastrous	dizasteros
disc	disk
discard	diskard
discharge	discarj
disciplinarian	disiplinarian
disciplinary	disiplinaré
discipline	disiplin
disclose	disklóz
disclosure	disklózúr
discount	diskq́nt
discourage	diskuraj
discourse	diskórs
discover	diskuver
discovery	diskuveré
discretion	diskresion
discretionary	diskresionaré
discriminate	diskriminát
discrimination	diskriminásion
discriminatory	diskriminatoré
discuss	diskus
discussion	diskusion
disease	dizéz
disgrace	disgraʸs
disgraceful	disgrásfql
disgruntle	disgruntel
disgust	disgust
dish	dix
dishonest	disonest
dishonesty	disonesté
dishonour	disonor
disk	disk
dislike	disliʸk
dismiss	dismis
dismissal	dismisal
disorder	disorder
disorganise	disorganíz
disorganize	disorganíz
displace	displaʸs
displacement	displaʸsment
display	displaʸ
disposal	dispózal
dispose	dispóz
disposition	dispozision
dispute	dispút
disrupt	disrupt
disruption	disrupsion
dissolution	disolúsion
dissolve	dizolv
distance	distans
distant	distant
distinct	distiŋkt
distinction	distiŋksion
distinctive	distiŋktiv
distinguish	distiŋgwix
distort	distort
distortion	distorsion
distract	distrakt
distraction	distraksion
distress	distres
distribute	distribút
distribution	distribúsion
distributive	distribútiv
distributor	distribútor
district	distrikt
disturb	disturb
disturbance	disturbans
ditch	dic
dive	diʸv
diverse	divers
diversification	diversifikásion
diversify	diversifí
diversion	diversion
diversity	diversité
divert	divert
divide	divíd
dividend	dividend
divine	divín
divinity	divinité
division	divizion
divisive	divísiv
divisor	divízor
divorce	divórs
do	dq̇
doctor	doktor
doctoral	doktoral
doctorate	doktorat
doctrine	doktrin
document	dokúment
documentary	dokúmentaré
documentation	dokúmentásion
does	duz
doesn't	duznt
dog	dog
doll	dol
dollar	dolar
domain	dómán
domestic	dómestik
domesticate	dómestikát
dominance	dominnas
dominant	dominant
dominate	dominát
domination	dominásion
dominion	dominion
donate	dónát
donation	dónásion
done	dun
donor	dónor
don't	doʷnt
door	doʷr
doorway	doʷrwaʸ
dose	doʷs
dot	dot
double	dubel
doubt	dqʷt
doubtful	dqʷtfql
down	dqʷn
downfall	dqʷnfål
download	dqʷnloʷd
downstairs	dqʷnstaʸrz
downtown	dqʷntqʷn
dozen	duzen
draft	draft
drag	drag
dragon	dragon
dragonfly	dragonfliʸ
drain	draʸn
drainage	draʸnaj
drainpipe	draʸnpiʸp
drama	drama
dramatic	dramatik
dramatise	dramatíz
dramatize	dramatíz
drank	draŋk
draw	drå
drawback	dråbak
drawer	drår
drawn	drån
dread	dred
dreadful	dredfql
dream	dreʸm
dreamt	dremt
dress	dres
drew	druʷ
drift	drift
drink	driŋk
drive	driʸv
driven	driven
driver	driʸver
driveway	driʸvwaʸ
drop	drop
drought	drqʷt
drown	drqʷn
drug	drug
drum	drum
drumstick	drumstik
drunk	druŋk
drunken	druŋken
dry	driʸ
dual	dúal
duality	dúalité
dub	dub
duct	dukt
due	duʷ
dug	dug
dull	dul
dumb	dum
dumbfound	dumfqʷnd
dummy	dumé
dump	dump
duo	dúó
duration	dúrásion
during	dúriŋ
dust	dust
duty	dúté
dynamic	dínamik
dynamite	dínamít
each	eʸc
eager	éger
ear	eʸr
early	erlé
earn	ern
earring	eʸrriŋ
earth	erþ
earthquake	erþkwaʸk
earthwork	erþwurk
ease	eʸz
east	eʸst
eastern	eʸstern
easy	eʸzé
eat	eʸt
eaten	eʸten
echo	ekó
ecological	ekolojikal
ecologist	ekolojist
ecology	ékolojé
economic	ekonomik
economical	ekonomikal
economise	ekonomíz
economist	ekonomist
economize	ekonomíz
economy	ekonomé
edge	ej
edit	edit
edition	edision
editor	editor
editorial	editórial
educate	edúkát
education	edúkásion
educational	edúkásional
educator	edúkátor
effect	efekt
effective	efektiv
efficacy	efikasé
efficiency	efisiensé
efficient	efisient
effort	effort
egg	eg
eggshell	egxel
ego	égó
eight	aʸt
eighteen	aʸteʸn
eighteenth	aʸteʸnþ
eighth	aʸtþ
eighty	aʸté
either	íðer
elaborate	elaborat
elaborate 2	elaborát
elaboration	elaborásion
elastic	elastik
elasticity	elastisité
elbow	elbó
elect	elekt
election	eleksion
electoral	elektoral
electorate	elektorat
electric	elektrik
electrical	elektrikal
electrician	elektrisian
electricity	elektrisité
electrify	elektrifí
electrocute	elektrokút
electron	elektron
electronic	elektronik
elegant	elegant
element	element
elemental	elemental
elementary	elementaré
elephant	elefant
elevate	elevát
elevation	elevásion
elevator	elevátor
eleven	eleven
eleventh	elevenþ
elf	elf
eligibility	elijibilité
eligible	elijibel
eliminate	eliminát
elimination	eliminásion
elite	elét
elitist	elétist
else	els
elsewhere	elshwaʸr
elves	elv
email	émaʸl
embark	embark
embarrass	embaras
embarrassment	embarasment
embassy	embasé
embed	embed
embody	embodé
embrace	embrás
emerge	emerj
emergence	emerjens
emergency	emerjensé
emergent	emerjent
emission	emision
emit	emit
emotion	emósion
emotional	emósional
emphasis	emfasis
emphasise	emfasíz
emphasize	emfasíz
empire	empír
empirical	empirikal
employ	emploʸ
employee	emploʸé
employer	emploʸer
employment	emploʸment
empower	empqʷr
empowerment	empqʷrment
empty	emté
enable	enábel
enact	enakt
enactment	enaktment
encompass	enkumpas
encounter	enkq́nter
encourage	enkuraj
encouragement	enkurajment
encyclopaedia	ensíklopédia
encyclopedia	ensíklopédia
end	end
endeavor	endevor
endeavour	endevor
endorse	endors
endorsement	endorsment
endow	endqʷ
endowment	endqʷment
endurance	endúrans
endure	endúr
enemy	enemé
energetic	enerjetik
energise	enerjíz
energize	enerjíz
energy	enerjé
enforce	enfórs
enforcement	enfórsment
engage	engáj
engagement	engájment
engine	enjin
engineer	enjinér
enhance	enhans
enhancement	enhansment
enjoy	enjoʸ
enjoyment	enjoʸment
enormity	enormité
enormous	enormos
enough	enuf
enquire	enkwír
enquiry	enkwíré
enrich	enric
enrichment	enricment
ensue	ensú
ensure	enxúr
enter	enter
enterprise	enterpríz
entertain	entertán
entertainment	entertánment
enthuse	enþúz
enthusiasm	enþúziazem
enthusiast	enþúziast
enthusiastic	enþúziastik
entire	entír
entirety	entíreté
entitle	entítel
entitlement	entítelment
entity	entité
entrance	entrans
entrepreneur	antreprener
entry	entré
envelop	envelop
envelope	envelóp
environment	envíronment
environmental	envíronmental
environmentalism	envíronmentalizem
environmentalist	envíronmentalist
envy	envé
epidemic	epidemik
epidemiological	epidémiolojikal
epidemiologist	epidémiolojist
epidemiology	epidémiolojé
episode	episód
episodic	episodik
equal	ékwol
equalise	ékwolíz
equality	ékwolité
equalization	ékwolizásion
equalize	ékwolíz
equate	ekwát
equation	ekwásion
equator	ékwátor
equatorial	ekwatórial
equip	ekwip
equipment	ekwipment
equivalence	ekwivalens
equivalent	ekwivalent
era	era
erect	erekt
erection	ereksion
erode	eród
erosion	erózion
error	eror
erupt	erupt
eruption	erupsion
escalate	eskalát
escalation	eskalásion
escalator	eskalátor
escape	eskáp
essay	esaʸ
essayist	esaʸist
essence	esens
essential	esensial
establish	establix
establishment	establixment
estate	estát
estimate	estimát
estimation	estimásion
estimator	estimátot
eternal	eternal
eternity	eternité
ethic	eþik
ethical	eþikal
ethnic	eþnik
ethnicity	eþnisité
euro	úró
evacuate	evakúát
evacuation	evakúásion
evacuee	evakúé
evaluate	evalúát
evaluation	evalúásion
evaporate	evaporát
evaporation	evaporásion
even	éven
evening	éveniŋ
event	event
eventual	eventúal
eventuality	eventúalité
ever	ever
evergreen	evergreʸn
every	everé
everybody	everébodé
everyday	everédaʸ
everyone	everéwun
everything	everéþiŋ
everywhere	everéhwaʸr
evidence	evidens
evident	evident
evil	évil
evoke	evók
evolution	evolúsion
evolutionary	evolúsionaré
evolve	evolv
exact	egzakt
exaggerate	egzajerát
exaggeration	egzajerásion
exam	egzam
examination	egzaminásion
examine	egzamin
example	egzampel
exceed	ekséd
excel	eksel
excellence	ekselens
excellency	ekselensé
excellent	ekselent
except	eksept
exception	eksepsion
exceptional	eksepsional
excess	ekses
excessive	eksesiv
exchange	ekscánj
excite	eksít
excitement	eksítment
exclaim	eksklám
exclamation	eksklamásion
exclude	eksklúd
exclusion	eksklúzion
exclusionary	eksklúzionaré
exclusive	eksklúsiv
excuse	ekskús
excuse v	ekskúz
execute	eksekút
execution	eksekúsion
executive	egzekútiv
executor	egzekútor
exemplary	egzemplaré
exemplify	egzemplifí
exercise	eksersíz
exert	egzert
exertion	egzersion
exhibit	egzibit
exhibition	egzibision
exhibitor	egzibitor
exile	egzíl
exist	egzist
existence	egzistens
existent	egzistent
existential	egzistensial
exit	egzit
exotic	egzotik
expand	ekspand
expanse	ekspans
expansion	ekspansion
expansive	ekspansiv
expect	ekspekt
expectation	ekspektásion
expedite	ekspedít
expedition	ekspedision
expenditure	ekspenditúr
expense	ekspens
expensive	ekspensiv
experience	ekspériens
experiment	eksperiment
experimental	eksperimental
experimentation	eksperimentásion
expert	ekspert
expertise	ekspertéz
expire	ekspír
explain	eksplán
explanation	eksplanásion
explanatory	eksplanatoré
explicit	eksplisit
explode	eksplód
exploit	eksploʸt
exploitation	eksploʸtásion
exploration	eksplorásion
exploratory	eksplóratoré
explore	eksplór
explosion	eksplózion
explosive	eksplósiv
export	eksport
expose	ekspóz
exposition	ekspozision
exposure	ekspózúr
express	ekspres
expression	ekspresion
expressive	ekspresiv
extend	ekstend
extension	ekstension
extensive	ekstensiv
extent	ekstent
exterior	ekstérior
external	eksternal
externalize	eksternalíz
extinct	ekstiŋkt
extinction	ekstiŋksion
extinguish	ekstiŋgwix
extra	ekstra
extract	ekstrakt
extraction	ekstraksion
extraordinary	ekstrordinaré
extreme	ekstrém
extremism	ekstrémizem
extremist	ekstrémist
extremity	ekstremité
eye	iʸ
eyeball	iʸbål
eyebrow	iʸbrqʷ
eyeglass	iʸglas
eyelash	iʸlax
eyelid	iʸlid
eyeshadow	iʸxadó
eyesight	iʸsiʸt
eyewitness	iʸwitnes
fabric	fabrik
fabricate	fabrikát
fabrication	fabrikásion
fabulous	fabúlos
face	faʸs
facial	fásial
facilitate	fasilitát
facilitation	fasilitásion
facilitator	fasilitátor
facility	fasilité
fact	fakt
faction	faksion
factor	faktor
factory	faktoré
factual	faktúal
faculty	fakulté
fade	faʸd
fail	faʸl
failure	fálúr
faint	faʸnt
fair	faʸr
faith	faʸþ
faithful	faʸþfql
fake	faʸk
fall	fål
fallen	fålen
false	fols
falsehood	folshqd
falsification	folsifikásion
falsify	folsifí
fame	faʸm
familial	familial
familiar	familiar
familiarise	familiaríz
familiarity	familiarité
familiarize	familiaríz
family	familé
famous	fámos
fan	fan
fanatic	fanatik
fanatical	fanatikal
fanciful	fansefql
fancy	fansé
fantastic	fantastik
fantasy	fantasé
far	far
fare	faʸr
farewell	faʸrʷel
farm	farm
farmhouse	farmhqʷs
farmland	farmland
farther	farðer
farthest	farðest
fashion	fasion
fast	fast
fasten	fasen
fat	fat
fatal	fátal
fatality	fátalité
fate	faʸt
fateful	faʸtfql
father	faðer
fault	fålt
faulty	fålté
favor	fávor
favorite	fávorit
favour	fávor
favourite	fávorit
fear	feʸr
fearful	feʸrfql
feat	feʸt
feather	feðer
feature	fétúr
february	febrúaré
fed	fed
federal	federal
federalism	federalizem
federalist	federalist
fee	feʸ
feeble	fébel
feed	feʸd
feedback	feʸdbak
feel	feʸl
feet	feʸt
fellow	feló
fellowship	felóxip
female	fémál
feminine	feminin
femininity	femininité
feminism	feminizem
feminist	feminist
fence	fens
ferment	ferment
fermentation	fermentásion
fertile	fertíl
fertilise	fertilíz
fertilization	fertilizásion
fertilize	fertilíz
festival	festival
festive	festiv
festivity	festivité
fever	féver
few	fuʷ
fiber	fíber
fiberglass	fíberglas
fibre	fíber
fiction	fiksion
fictional	fiksional
fictitious	fiktisios
field	feʸld
fierce	feʸrs
fifteen	fifteʸn
fifteenth	fifténþ
fifth	fifþ
fifty	fifté
fight	fiʸt
figurative	figúrativ
figure	figúr
figurehead	figúrhed
figurine	figúrén
file	fiʸl
fill	fil
film	film
filmmake	filmmaʸk
filter	filter
fin	fin
final	fínal
finale	finalé
finalise	fínalíz
finalist	fínalist
finalize	fínalíz
finance	finans
financial	finansial
financier	finansér
find	fiʸnd
fine	fiʸn
finger	fiŋger
fingernail	fiŋgernaʸl
fingerprint	fiŋgerprint
fingertip	fiŋgertip
finish	finix
fire	fiʸr
firearm	fiʸrarm
fireball	fiʸrbål
firebomb	fiʸrbom
firecracker	fiʸrkraker
firefight	fiʸrfiʸt
firefighter	fiʸrfiʸter
firefly	fiʸrfliʸ
fireman	fiʸrman
fireplace	fiʸrplaʸs
firework	fiʸrwurk
firm	firm
first	first
fish	fix
fisherman	fixerman
fishery	fixeré
fit	fit
five	fiʸv
fix	fiks
fixate	fiksát
fixation	fiksásion
fixture	fikstúr
flag	flag
flagship	flagxip
flame	flaʸm
flammable	flamabel
flash	flax
flashback	flaxbak
flashlight	flaxliʸt
flashy	flaxé
flask	flask
flat	flat
flavor	flávor
flavour	flávor
flaw	flå
fled	fled
flee	fleʸ
fleet	fleʸt
flesh	flex
flew	fluʷ
flexibility	fleksibilité
flexible	fleksibel
flight	fliʸt
flint	flint
float	floʷt
flood	flud
floodgate	fludgaʸt
floor	floʷr
floorboard	floʷrboʷrd
flotation	flótásion
flour	flqʷr
flourish	flurix
flow	floʷ
flower	flqʷr
flown	floʷn
flu	fluʷ
fluid	flúid
fly	fliʸ
focus	fókus
fold	foʷld
folk	foʷk
folklore	foʷkloʷr
follow	foló
followup	folóup
fond	fond
food	fq̇d
fool	fq̇l
foolish	fq̇lix
foot	fqt
footage	fqtaj
football	fqtbål
foothold	fqthoʷld
footman	fqtman
footnote	fqtnoʷt
footprint	fqtprint
footstep	fqtstep
footwear	fqtwaʸr
for	for
forbade	forbad
forbid	forbid
forbidden	forbiden
force	foʷrs
forceful	foʷrsfql
forcible	forsibel
forecast	foʷrkast
forehead	foʷrhed
foreign	foran
forest	forest
forestry	forestré
forever	forever
forgave	forgaʸv
forge	fórj
forgery	fórjeré
forget	forget
forgive	forgiv
forgiven	forgiven
forgot	forgot
forgotten	forgoten
fork	fork
form	form
formal	formal
formalise	formalíz
formalize	formalíz
format	format
formation	formásion
formative	formativ
former	former
formula	formúla
formulate	formúlát
formulation	formúlásion
forth	foʷrþ
fortunate	fortúnat
fortune	fortún
forty	forté
forum	forum
forward	forword
fossil	fosil
fossilise	fosilíz
fossilize	fosilíz
foster	foster
fought	fåt
foul	fqʷl
found	fqʷnd
foundation	fq́ndásion
foundational	fq́ndásional
founder	fqʷnder
fountain	fq́ntan
four	foʷr
fourteen	foʷrteʸn
fourteenth	foʷrteʸnþ
fourth	foʷrþ
fowl	fqʷl
fractal	fraktal
fraction	fraksion
fractional	fraksional
fracture	fraktúr
fragile	frajíl
fragment	fragment
fragmentation	fragmentásion
frame	fraʸm
framework	fraʸmwurk
franchise	francíz
frank	fraŋk
fraud	fråd
fraudster	frådster
fraudulent	frådúlent
free	freʸ
freedom	freʸdom
freeway	freʸwaʸ
freeze	freʸz
frequency	frékwensé
frequent	frékwent
fresh	frex
freshen	frexen
fricative	frikativ
friction	friksion
friday	frídaʸ
fridge	frij
friend	frend
friendship	frendxip
fright	friʸt
frighten	friʸten
frightful	friʸtfql
frog	frog
from	from
front	frunt
frontal	fruntal
frost	frost
froze	froʷz
frozen	froʷzen
fruit	fruʷt
fruitful	fruʷtfql
fruition	frúision
frustrate	frustrát
frustration	frustrásion
fry	friʸ
fuel	fuʷl
fulfil	fqlfil
fulfill	fqlfil
fulfillment	fqlfilment
fulfilment	fqlfilment
full	fql
fume	fuʷm
fun	fun
function	fuŋksion
functional	fuŋksional
functionality	fuŋksionalité
fund	fund
fundamental	fundamental
fundamentalism	fundamental
fundamentalist	fundamentalist
funeral	fúneral
funnel	funel
funny	funé
fur	fur
furious	fúrios
furnace	furnas
furnish	furnix
furniture	furnitúr
further	furðer
furthermore	furðermoʷr
fusion	fúzion
future	fútúr
futurist	fútúrist
futuristic	fútúristik
gain	gaʸn
gallery	galeré
gallon	galon
game	gaʸm
gang	gaŋ
gap	gap
garage	garaj
garden	garden
gas	gas
gaseous	gasios
gat	gat
gate	gaʸt
gateway	gaʸtwaʸ
gather	gaðer
gave	gaʸv
gay	gaʸ
gaze	gaʸz
gear	geʸr
gender	jender
gene	jeʸn
genealogical	jénéalojikal
genealogy	jénéalojé
general	jeneral
generalisation	jeneralizásion
generalise	jeneralíz
generalization	jeneralizásion
generalize	jeneralíz
generate	jenerát
generation	jenerásion
generational	jenerásional
generative	jenerativ
generator	jenerátor
generic	jenerik
generosity	jenerosité
generous	jeneros
genetic	jenetik
geneticist	jenetisist
genius	jénius
genocide	jenosíd
genre	zjanra
gentle	jentel
gentleman	jentelman
genuine	jenúin
geographic	jéografik
geographical	jéografikal
geography	jéografé
geology	jéolojé
geometry	jéometré
germ	jerm
gesticulate	jestikúlát
gesture	jestúr
get	get
ghost	goʷst
giant	jíant
gift	gift
gig	gig
gill	gil
girl	girl
girlfriend	girlfrend
give	giv
giveaway	givawaʸ
glacier	glásier
glad	glad
gladden	gladen
glance	glans
gland	gland
glandular	glandúlar
glass	glas
glimpse	glims
global	glóbal
globalisation	glóbalizásion
globalization	glóbalizásion
globalize	glóbalíz
globe	gloʷb
globular	globúlar
glorify	glórifí
glorious	glórios
glory	glóré
glove	gluv
go	goʷ
goal	goʷl
goat	goʷt
god	god
gold	goʷld
golden	goʷlden
golf	golf
gone	gon
good	gqd
goodbye	gqdbí
gorgeous	gorjos
got	got
govern	guvern
governance	guvernans
government	guvernment
governmental	guvernmental
governor	guvernor
governorship	guvernorxip
grab	grab
grace	graʸs
graceful	graʸsfql
gracious	grásios
grade	graʸd
gradual	gradúal
graduate	gradúát
graduation	gradúásion
grain	graʸn
gram	gram
grammar	gramar
grammarian	gramarian
grammatical	gramatikal
grand	grand
grandfather	grandfaðer
grandmother	grandmuðer
grandparent	grandpárent
grant	grant
graphic	grafik
grasp	grasp
grass	gras
grateful	graʸtfql
grave	graʸv
gravel	gravel
gravity	gravité
grease	greʸs
greasy	greʸsé
great	graʸt
green	greʸn
greenhouse	greʸnhqʷs
greet	greʸt
grew	gruʷ
grey	graʸ
grid	grid
grief	greʸf
grievance	grévans
grieve	greʸv
grin	grin
grind	griʸnd
grip	grip
grocer	gróser
grocery	gróseré
groove	grq̇v
gross	groʷs
ground	grqʷnd
groundbreak	grqʷndbraʸk
group	grq̇p
grow	groʷ
grown	groʷn
growth	groʷþ
guarantee	garanté
guard	gard
guerrilla	gerila
guess	ges
guest	gest
guestbook	gestbqk
guesthouse	gesthqʷs
guidance	gídans
guide	giʸd
guidebook	giʸdbqk
guideline	giʸdliʸn
guilt	gilt
guilty	gilté
guitar	gitar
guitarist	gitarist
gum	gum
gun	gun
gunboat	gunboʷt
gunfire	gunfiʸr
gunman	gunman
gunpowder	gunpqʷder
gut	gut
guy	giʸ
gym	jim
gymnasium	jimnázium
gymnast	jimnast
habit	habit
habitat	habitat
habitation	habitásion
habitual	habitúal
had	had
hadn't	hadnt
hail	haʸl
hailstone	haʸlstoʷn
hair	haʸr
haircut	haʸrkut
hairdresser	haʸrdreser
hairdryer	haʸrdriʸer
hairpin	haʸrpin
hairspray	haʸrspraʸ
hairstyle	haʸrstiʸl
hairy	haʸré
half	haf
halfling	hafliŋ
halfway	hafwaʸ
hall	hål
halt	hålt
hammer	hamer
hand	hand
handbook	handbqk
handful	handfql
handheld	handheld
handhold	handhoʷld
handkerchief	haŋkercef
handle	handel
handy	handé
hang	haŋ
happen	happen
happy	hapé
harassment	harasment
harbor	harbor
harbour	harbor
hard	hard
hardship	hardxip
hardware	hardwaʸr
harm	harm
harmful	harmfql
harmonic	harmonik
harmonious	harmónios
harmonise	harmoníz
harmonization	harmonizásion
harmonize	harmoníz
harmony	harmoné
harsh	harx
harvest	harvest
has	haz
hasn't	haznt
hat	hat
hate	haʸt
hateful	haʸtfql
hatred	hátred
haunt	hånt
have	hav
haven't	havnt
hazard	hazard
hazardous	hazardos
he	heʸ
head	hed
headache	hedaʸk
headdress	heddres
headland	hedland
headline	hedliʸn
headstone	hedstoʷn
heal	heʸl
health	helþ
healthcare	helþkaʸr
healthy	helþé
hear	heʸr
heard	herd
hearsay	heʸrsaʸ
heart	hart
heartbeat	hartbeʸt
heartbreak	hartbraʸk
heartbroken	hartbroʷken
hearty	harté
heat	heʸt
heaven	heven
heavy	hevé
heavyweight	hevéʷaʸt
he'd	heʸd
hedge	hej
heel	heʸl
height	hiʸt
heighten	hiʸten
held	held
helicopter	helikopter
hell	hel
he'll	heʸl
hello	heló
helmet	helmet
help	help
helpful	helpfql
hence	hens
henceforth	hensfoʷrþ
her	her
herb	herb
herbal	herbal
here	heʸr
hereafter	heʸrafter
hereditary	hereditaré
heredity	heredité
heritage	heritaj
hero	héró
heroic	heróik
heroin	heróin
heroine	heróin
heroism	heróizem
hers	herz
herself	herself
he's	heʸz
hesitancy	hezitansé
hesitant	hezitant
hesitate	hezitát
hesitation	hezitásion
hey	haʸ
hi	hiʸ
hid	hid
hidden	hiden
hide	hiʸd
hideout	hiʸdqʷt
hierarchical	hírarkikal
hierarchy	hírarké
high	hiʸ
highlight	hiʸliʸt
highway	hiʸwaʸ
hilarious	hilários
hilarity	hilárité
hill	hil
him	him
himself	himself
hinge	hinj
hint	hint
hip	hip
hire	hiʸr
his	hiz
hiss	his
historian	historian
historic	historik
historical	historikal
history	historé
hit	hit
hobby	hobé
hobbyist	hobéist
hockey	hoké
hold	hoʷld
hole	hoʷl
holiday	holidaʸ
hollow	holó
holy	hoʷlé
home	hoʷm
homebuyer	hoʷmbiʸer
homecome	hoʷmkum
homeland	hoʷmland
homemade	hoʷmmaʸd
homemake	hoʷmmaʸk
homeown	hoʷmoʷn
homepage	hoʷmpaʸj
homeschool	hoʷmskq̇l
homestead	hoʷmsted
hometown	hoʷmtqʷn
homework	hoʷmwurk
honest	onest
honesty	onesté
honey	huné
honor	onor
honorary	onoraré
honorific	onorifik
honour	onor
hoof	hqf
hook	hqk
hope	hoʷp
hopeful	hoʷpfql
horizon	horízon
horizontal	horizontal
horn	horn
horrible	horibel
horrific	horifik
horror	horor
horse	hors
horseback	horsbak
horsepower	horspqʷr
horserace	horsraʸs
horseshoe	horsxuʷ
hospice	hospis
hospital	hospital
hospitalise	hospitalíz
hospitality	hospitalité
hospitalization	hospitalizásion
hospitalize	hospitalíz
host	hoʷst
hostage	hostaj
hostess	hoʷstes
hostile	hostíl
hostility	hostilité
hot	hot
hotel	hótel
hour	qʷr
house	hqʷs
house v	hqʷz
houseboat	hqʷsboʷt
household	hqʷshoʷld
housekeep	hqʷskeʸkp
houses	hqʷzez
how	hqʷ
however	hqʷever
huge	huʷj
human	húman
humane	húmán
humanise	húmaníz
humanism	húmanizem
humanist	húmanist
humanitarian	húmanitárian
humanity	húmanité
humanize	húmaníz
humble	humbel
humor	húmor
humorous	húmoros
humour	húmor
hundred	hundred
hung	huŋ
hunger	huŋger
hungry	huŋgeré
hunt	hunt
hurricane	hurikán
hurry	huré
hurt	hurt
hurtful	hurtfql
husband	huzband
hydrogen	hídrojen
hyena	híéna
hygiene	híjén
hygienic	híjenik
hypothesis	hípoþesis
hypothesise	hípoþesíz
hypothesize	hípoþesíz
hypothetical	hípoþetikal
hysteria	histeria
hysteric	histerik
hysterical	histerikal
i	iʸ
ice	iʸs
icon	íkon
iconic	íkonik
i'd	iʸd
idea	ídéa
ideal	ídéal
idealism	ídéalizem
idealist	ídéalist
idealistic	ídéalistik
idealization	ídéalizásion
idealize	ídéalíz
identical	ídentikal
identification	ídentifikásion
identify	ídentifí
identity	ídentité
ideological	idéolojikal
ideologue	ídéolog
ideology	ídéolojé
idiocy	idiosé
idiot	idiot
idiotic	idiotik
if	if
ignorance	ignorans
ignorant	ignorant
ignore	ignór
ill	il
i'll	iʸl
illegal	ilégal
illegality	ilegalité
illusion	ilúzion
illustrate	ilustrát
illustration	ilustrásion
illustrative	ilustrativ
illustrator	ilustrátor
i'm	iʸm
image	imaj
imagery	imajré
imaginary	imajinaré
imagination	imajinásion
imaginative	imajinativ
imagine	imajin
immediate	imédiat
immense	imens
immigrant	imigrant
immigrate	imigrát
immigration	imigrásion
imminent	iminent
immune	imún
immunisation	imúnizásion
immunise	imúníz
immunity	imúnité
immunization	imúnizásion
immunize	imúníz
impact	impakt
impactful	impaktfql
impatience	impásiens
impatient	impásient
imperfect	imperfekt
imperfection	imperfeksion
imperial	impérial
imperialism	impérializem
imperialist	impérialist
implement	implement
implementation	implementásion
implication	implikásion
imply	implí
import	import
importance	importans
important	important
impose	impóz
imposition	impozision
impossibility	imposibilité
impossible	imposibel
impress	impres
impression	impresion
impressive	impresiv
imprison	imprizon
imprisonment	imprizonment
improve	imprq̇v
improvement	imprq̇vment
impulse	impuls
impurity	impúrité
in	in
inability	inabilité
inadequate	inadekwat
inappropriate	inaprópriat
inasmuch	inazmuc
incentive	insentiv
incentivize	insentivíz
inch	inc
incidence	insidens
incident	insident
incline	inklín
include	inklúd
inclusion	inklúzion
inclusive	inklúsiv
income	inkum
incorporate	inkorporát
incorporation	inkorporásion
incorrect	inkorekt
increase	inkrés
incredible	inkredibel
incur	inkur
incursion	inkurzion
indeed	indeʸd
independence	independens
independent	independent
index	indeks
indicate	indikát
indication	indikásion
indicator	indikátor
indices	indiséz
indict	indít
indictment	indítment
indigenous	indijenos
indirect	indirekt
individual	individúal
individualism	individúalizem
individuality	individúalité
indoor	indoʷr
induce	indús
inducement	indúsment
indulge	indulj
indulgence	induljens
industrial	industrial
industrialise	industrialíz
industrialist	industrialist
industrialization	industrializásion
industrialize	industrialíz
industry	industré
inequality	inekwolité
inevitability	inevitabilité
inevitable	inevitabel
inexpensive	inekspensiv
inexperience	inekspériens
infamous	infamos
infancy	infansé
infant	infant
infect	infekt
infection	infeksion
infectious	infeksios
infer	infer
inference	inferens
inferior	inférior
inferiority	infériorité
infinitive	infinitiv
infinity	infinité
inflate	inflát
inflation	inflásion
inflationary	inflásionaré
inflict	inflikt
inflow	infloʷ
influence	inflúens
influential	inflúensial
influenza	inflúenza
influx	influks
info	infó
inform	inform
informal	informal
informant	informant
information	informásion
informative	informativ
infrastructure	infrastruktúr
ingredient	ingrédient
inhabit	inhabit
inhabitant	inhabitant
inherent	inherent
inherit	inherit
inheritance	inheritans
inheritor	inheritor
inhibit	inhibit
inhibition	inhibision
inhibitor	inhibitor
inhuman	inhúman
inhumane	inhúmán
initial	inisial
initialise	inisialíz
initialization	inisializásion
initialize	inisialíz
initiate	inisiát
initiation	inisiásion
initiative	inisiativ
initiator	inisiátor
inject	injekt
injection	injeksion
injector	injektor
injure	injúr
injury	injúré
injustice	injustis
ink	iŋk
inland	inland
inlet	inlet
inmate	inmát
inn	in
innate	inát
inner	iner
innocence	inosens
innocent	inosent
innovate	inovát
innovation	inovásion
innovative	inovátiv
innovator	inovátor
input	inpqt
inquire	inkwír
inquiry	inkwiré
insect	insekt
insecticide	insektisíd
insectivore	insektivór
insecure	insekúr
insecurity	insekúrité
insensitive	insensitiv
inseparable	inseparabel
insert	insert
insertion	inersion
inside	insíd
insight	insiʸt
insightful	insiʸtfql
insist	insist
insistence	insistens
inspect	inspekt
inspection	inspeksion
inspector	inspektor
inspiration	inspirásion
inspirational	inspirásional
inspire	inspír
install	instål
installation	instålásion
installment	instålment
instalment	instålment
instance	instans
instant	instant
instantaneous	instantánéos
instead	instead
instinct	instiŋkt
instinctive	instiŋktiv
institute	institút
institution	institúsion
institutional	institúsional
institutionalise	institúsionalíz
institutionalize	institúsionalíz
instruct	instrukt
instruction	instruksion
instructional	instruksional
instructive	instruktiv
instructor	instruktor
instrument	instrúment
instrumental	instrúmental
instrumentation	instrúmentásion
insufficient	insufisient
insulate	insulát
insulation	insúlásion
insulator	insulátor
insult	insult
insurance	inxúrans
intact	intakt
intake	intaʸk
integer	intejer
integral	inegral
integrate	integrát
integration	integrásion
integrity	integrité
intellect	intelekt
intellectual	intelektúal
intelligence	inteligens
intelligent	intelijent
intend	intend
intense	intens
intensify	intensifí
intensity	intensité
intensive	intensiv
intent	intent
intention	intension
intentional	intensional
interact	interakt
interaction	interaksion
interactive	interaktiv
intercept	intersept
interception	intersepsion
interceptor	interseptor
interest	interest
interface	interfás
interfere	interfér
interference	interférens
interim	interim
interior	intérior
intermediary	intermédiaré
intermediate	intermédiát
internal	internal
internalise	internalíz
internalize	internalíz
international	internasional
internet	internet
interpret	interpret
interpretation	interpretásion
interrupt	interupt
interruption	interupsion
intersect	intersekt
intersection	interseksion
interval	interval
intervene	intervén
intervention	intervension
interview	intervú
interviewee	intervúé
intestine	intestin
intimate	intimat
intimate 2	intimát
intimation	intimásion
into	intq̇
intro	intró
introduce	introdús
introduction	introduksion
introductory	introduktoré
intrude	intrúd
intrusion	intrúzion
invade	invád
invasion	invázion
invasive	invásiv
invent	invent
invention	invension
inventive	inventiv
inventor	inventor
inverse	invers
inversion	inverzion
invert	invert
invest	invest
investigate	investigát
investigation	investigásion
investigative	investigativ
investigator	investigátor
investment	investment
investor	investor
invisible	invizibel
invitation	invitásion
invite	invít
invocation	invokásion
invoke	invók
involuntary	involuntaré
involve	involv
involvement	involvment
iron	íarn
ironic	íronik
irony	íroné
irrational	irasional
irrationality	irasionalité
irregular	iregúlar
irregularity	iregúlarité
irrelevant	irelevant
irreversible	ireversibel
irritate	iritát
irritation	iritásion
is	iz
island	íland
isn't	iznt
isolate	ísolát
isolation	ísolásion
isolator	ísolátor
issuance	isúans
issue	isú
it	it
it'd	itd
item	ítem
itemise	ítemíz
itemize	ítemíz
it'll	itl
its	its
it's	its
itself	itself
i've	iʸv
jacket	jaket
jail	jaʸl
jam	jam
january	janúaré
jaw	jå
jawbone	jåboʷn
jazz	jaz
jealous	jelos
jealousy	jelosé
jean	jeʸn
jelly	jelé
jellyfish	jeléfix
jerk	jerk
jet	jet
jewel	júel
jewellery	júeleré
job	job
join	joʸn
joint	joʸnt
joke	joʷk
journal	jurnal
journalism	jurnalizem
journalist	jurnalist
journalistic	jurnalistik
journey	jurné
joy	joʸ
joyful	joʸfql
joyous	joʸos
judge	juj
judgement	jujment
judgment	jujment
judgmental	jujmental
judicial	júdisial
judiciary	júdisiaré
jug	jug
juice	juʷs
juicy	juʷsé
july	júlí
jump	jump
junction	juŋksion
june	juʷn
junior	júnior
jurisdiction	júrisdiksion
jurisdictional	júrisdiksional
jury	júré
just	just
justice	justis
justification	justifikásion
justify	justifí
keen	keʸn
keep	keʸp
kennel	kenel
kept	kept
kettle	ketel
key	keʸ
keyboard	keʸboʷrd
keyword	keʸwurd
kick	kik
kid	kid
kidnap	kidnap
kidney	kidné
kill	kil
kilometer	kilometer
kilometre	kilometer
kind	kiʸnd
king	kiŋ
kingdom	kiŋdom
kiss	kis
kit	kit
kitchen	kicen
kitchenette	kicenet
knee	neʸ
kneecap	neʸkap
knelt	nelt
knew	nuʷ
knife	niʸf
knive	niʸv
knock	nok
knockout	nokqʷt
knot	not
know	noʷ
knowledge	nolej
known	noʷn
lab	lab
label	lábel
labor	lábor
laboratory	laboratoré
labour	lábor
lace	laʸs
lack	lak
lad	lad
ladder	lader
lady	ládé
lag	lag
laid	laʸd
lain	laʸn
lake	laʸk
lame	laʸm
lamp	lamp
land	land
landlord	landlord
landmark	landmark
landscape	landskaʸp
landslip	landslip
lane	laʸn
language	laŋgwaj
lap	lap
laptop	laptop
large	larj
laser	lázer
last	last
late	laʸt
latitude	latitúd
latter	later
laugh	laf
laughter	lafter
launch	lånc
lava	lava
law	lå
lawn	lån
lawsuit	låsuʷt
lawyer	låier
lay	laʸ
layer	laʸer
layout	laʸqʷt
laze	laʸz
lazy	laʸzé
lead	led
lead v	leʸd
leader	leʸder
leadership	leʸderxip
leaf	leʸf
leaflet	leʸflet
leafy	leʸfé
league	leʸg
leak	leʸk
leakage	leʸkaj
lean	leʸn
leant	leʸnt
leap	leʸp
learn	lern
learnt	lernt
least	leʸst
leather	leðer
leave	leʸv
lecture	lektúr
left	left
leg	leg
legacy	legasé
legal	légal
legalise	légalíz
legality	légalité
legalization	légalizásion
legalize	légalíz
legend	lejend
legendary	lejendaré
legislate	lejislát
legislation	lejislásion
legislative	lejislátiv
legislator	lejislátor
legislature	lejislátúr
legitimacy	lejitimasé
legitimate	lejitimat
legitimise	lejitimíz
legitimize	lejitimíz
leisure	lezúr
lemon	lemon
lemonade	lemonád
lend	lend
length	leŋþ
lengthen	leŋþen
lengthy	leŋþé
lens	lenz
lent	lent
lesbian	lezbian
less	les
lessen	lesen
lesson	leson
let	let
lethal	léþal
let's	lets
letter	leter
level	level
lever	lever
leverage	leveraj
liability	líabilité
liable	líabel
liberal	liberal
liberalism	liberalizem
liberate	liberát
liberation	liberásion
liberator	liberátor
liberty	liberté
librarian	líbrárian
library	líbraré
licence	lísens
licencee	lísensé
license	lísens
licensee	lísensé
lid	lid
lie	liʸ
life	liʸf
lifeboat	liʸfboʷt
lifecycle	liʸfsíkel
lifeline	liʸfliʸn
lifelong	liʸfloŋ
lifespan	liʸfspan
lifestyle	liʸfstiʸl
lifetime	liʸftiʸm
lift	lift
light	liʸt
lightbulb	liʸtbulg
lighten	liʸten
lightheart	liʸthart
lighthouse	liʸthqʷs
lightning	liʸtniŋ
lightweight	liʸtwaʸt
like	liʸk
likelihood	liʸkléhqd
liken	liʸken
likewise	liʸkwiʸz
limb	lim
lime	liʸm
limestone	liʸmstoʷn
limit	limit
limitation	limitásion
line	liʸn
lineage	linéaj
linear	linéar
linen	linen
linger	liŋger
linguist	liŋgwist
linguistic	liŋgwistik
link	liŋk
linkage	liŋkaj
lion	líon
lioness	líones
lip	lip
liquefaction	likwefaksion
liquefy	likwefí
liqueur	likúr
liquid	likwid
liquidate	likwidát
liquidation	likwidásion
liquidator	likwidátor
liquidity	likwidité
liquifaction	likwefaksion
liquify	likwifí
liquor	likor
list	list
listen	lisen
lit	lit
liter	léter
literacy	literasé
literal	literal
literary	literaré
literate	literat
literature	literatúr
litre	léter
litter	liter
little	litel
live	liʸv
live v	liv
livelihood	liʸvléhqd
liven	liʸven
liver	liver
load	loʷd
loan	loʷn
lobby	lobé
lobbyist	lobéist
local	lókal
locale	lókal
localise	lókalíz
locality	lókalité
localization	lókalizásion
localize	lókalíz
locate	lókát
location	lókásion
locator	lókátor
lock	lok
locus	lókus
log	log
logic	lojik
logical	lojikal
logistic	lojistik
logo	lógó
lone	loʷn
lonely	loʷnlé
long	loŋ
longer	loŋger
longevity	lonjevité
longitude	lonjitúd
longitudinal	lonjitúdinal
look	lqk
lookalike	lqkaliʸk
lookout	lqkqʷt
lookup	lqkup
loom	lq̇m
loop	lq̇p
loophole	lq̇phoʷl
loose	lq̇s
loosen	lq̇sen
lord	lord
lordship	lordxip
lorry	loré
lose	lq̇z
loss	los
lost	lost
lot	lot
lottery	loteré
loud	lqʷd
love	luv
lovebird	luvbird
low	loʷ
loyal	loʸal
loyalist	loʸalist
loyalty	loʸalté
luck	luk
lucky	luké
lump	lump
lumpy	lumpé
lunch	lunc
luncheon	luncon
lunchtime	lunctiʸm
lung	luŋ
luxurious	luksúrios
luxury	lugzúré
lyric	lirik
lyrical	lirikal
machine	maxén
machinery	maxéneré
mad	mad
madam	madam
made	maʸd
magazine	magazén
magic	majik
magical	majikal
magistrate	majistrát
magnet	magnet
magnetic	magnetik
magnetise	magnetíz
magnetism	magnetizem
magnetize	magnetíz
magnificent	magnifisent
magnitude	magnitúd
mail	maʸl
main	maʸn
mainland	maʸnland
mainstream	maʸnstreʸm
maintain	mántán
maintenance	mántenans
major	májor
majority	majorité
make	maʸk
makeup	maʸkup
malaria	malária
male	maʸl
mall	mål
man	man
manage	manaj
management	manajment
managerial	manajérial
mandate	mandát
mandatory	mandatoré
manhole	manhoʷl
manhood	manhqd
mania	mánia
maniac	mániak
manifest	manifest
manifestation	manifestásion
manipulate	manipúlát
manipulation	manipúlásion
manipulative	manipúlativ
manipulator	manipúlátor
manner	maner
mannerism	manerizem
manufacture	manúfaktúr
manuscript	manúskript
many	mané
map	map
marathon	maraþon
marble	marbel
march	marc
margin	marjin
marginal	marjinal
marginalise	marjinalíz
marginalize	marjinalíz
marine	marén
mark	mark
marker	marker
market	market
marketplace	marketplaʸs
marriage	maraj
marry	maré
martial	marsial
mask	mask
mass	mas
massacre	masaker
massive	masiv
mast	mast
master	master
match	mac
mate	maʸt
material	matérial
materialise	matérialíz
materialism	matérializem
materialist	matérialist
materialistic	matérialistik
materialize	matérialíz
math	maþ
mathematical	maþematikal
mathematician	maþematisian
matter	mater
mattress	matres
mature	matúr
maturity	matúrité
maximal	maksimal
maximise	maksimíz
maximize	maksimíz
maximum	maksimum
may	maʸ
maybe	maʸbeʸ
mayor	máor
mayorial	máórial
me	meʸ
meal	meʸl
mealtime	meʸltiʸm
mean	meʸn
meaningful	meʸniŋfql
meant	ment
meantime	meʸntiʸm
meanwhile	meʸnhwiʸl
measure	mezúr
measurement	mezúrment
meat	meʸt
meatball	meʸtbål
meaty	meʸté
mechanic	mekanik
mechanical	mekanikal
mechanism	mekanizem
mechanize	mekaníz
medal	medal
medallion	medalion
medallist	medalist
media	média
median	médian
mediate	médiát
mediation	médiásion
mediator	médiátor
medical	medikal
medicate	medikát
medication	medikásion
medicinal	medisinal
medicine	medisin
medieval	medéval
meditate	meditát
meditation	meditásion
medium	médium
meet	meʸt
meetup	meʸtup
melody	melodé
melt	melt
member	member
membership	meberxip
memo	memó
memoir	memwar
memorial	memórial
memorise	memoríz
memorize	memoríz
memory	memoré
men	men
mental	mental
mentality	mentalité
mention	mension
mentor	mentor
menu	menú
meow	méqʷ
merchant	mercant
mercy	mersé
mere	meʸr
merge	merj
merit	merit
mess	mes
message	mesaj
messenger	mesenjer
metabolic	metabolik
metabolise	metabolíz
metabolism	metabolizem
metabolize	metabolíz
metal	metal
metallic	metalik
metaphor	metafor
metaphoric	metafórik
metaphorical	metafórikal
meter	méter
method	meþod
methodist	meþodist
methodological	meþodolojikal
methodology	meþodolojé
metre	méter
metric	metrik
mice	miʸs
microscope	míkroskóp
microscopic	míkroskopik
middle	midel
middleman	midelman
midnight	midniʸt
midst	midst
might	miʸt
mighty	miʸté
migrant	mígrant
migrate	mígrát
migration	mígrásion
migratory	mígratóré
mild	miʸld
mile	miʸl
mileage	miʸlaj
militant	militant
militarism	militarizem
military	militaré
militia	milisia
milk	milk
mill	mil
million	milion
millionaire	milionár
mind	miʸnd
mindful	miʸndfql
mindset	miʸndset
mine	miʸn
mineral	mineral
minimal	minimal
minimalist	minimalist
minimalistic	minimalistik
minimise	minimíz
minimize	minimíz
minimum	minimum
minister	minister
ministerial	ministérial
ministry	ministré
minor	mínor
minority	mínorité
minute	minut
minute adj	mínút
miracle	mirakel
miraculous	mirakúlos
mirror	miror
miserable	mizerabel
misery	mizeré
miss	mis
missile	misil
mission	mision
missionary	misionaré
mist	mist
mistake	mistaʸk
mistaken	mistaʸken
mistook	mistqk
mix	miks
mixture	mikstúr
mob	mob
mobile	móbil
mobilise	móbilíz
mobility	móbilité
mobilization	móbilizásion
mobilize	móbilíz
mode	moʷd
model	model
moderate	moderat
moderate v	moderát
modern	modern
modernise	moderníz
modernism	modernizem
modernist	modernist
modernity	modernité
modernization	modernizásion
modernize	moderníz
modest	modest
modesty	modesté
modification	modifikásion
modify	modifí
mom	mom
moment	móment
momentary	mómentaré
momentous	mómentos
momentum	mómemtum
mommy	momé
monday	mundaʸ
money	muné
monitor	monitor
monk	muŋk
monkey	muŋké
monopoly	monopolé
monster	monster
monstrosity	monstrosité
monstrous	monstros
month	munþ
monument	monúment
monumental	monúmental
mood	mq̇d
moody	mq̇dé
moon	mq̇n
moral	moral
morale	moral
morality	moralité
more	moʷr
moreover	moʷróver
mortgage	morgaj
mosque	mosk
most	moʷst
mother	muðer
motherhood	muðerhqd
motion	mósion
motivate	mótivát
motivation	mótivásion
motivational	mótivásional
motive	mótiv
motor	mótor
motorcycle	mótorsíkel
motorist	mótorist
mount	mqʷnt
mountain	mq́ntan
mountaineer	mq́ntanér
mountainous	mq̇ntanos
mouse	mqʷs
moustache	mustax
mouth	mqʷþ
mouths	mqʷðz
move	mq̇v
movement	mq̇vment
movie	mq̇vé
mown	moʷn
much	muc
mud	mud
multiple	multipel
multiplication	multiplikásion
multiplicity	multiplisité
multiply	multiplí
mum	mum
municipal	múnisipal
municipality	múnisipalité
murder	murder
murderous	murderos
muscle	musel
museum	múzéum
music	múzik
musical	múzikal
musician	múzisian
must	must
mustn't	musnt
mutual	mútúal
my	miʸ
myself	miʸself
mysterious	mistérios
mystery	misteré
myth	miþ
mythic	myþik
mythical	myþikal
mythology	miþolojé
nail	naʸl
naked	náked
name	naʸm
narrate	narát
narration	narásion
narrative	narativ
narrator	narátor
narrow	naró
nasty	nasté
nation	násion
national	national
nationalise	nationalíz
nationalism	nationalizem
nationalist	nationalist
nationality	nationalité
nationalization	nationalizásion
nationalize	nationalíz
nationwide	násionwiʸd
native	nátiv
natural	natúral
naturalise	natúralíz
naturalist	natúralist
naturalistic	natúralistik
naturalization	natúralizásion
naturalize	natúralíz
nature	nátúr
naturist	nátúrist
naval	nával
navigate	navigát
navigation	navigásion
navigator	navigátor
navy	návé
near	neʸr
nearby	neʸrbiʸ
neat	neʸt
necessary	nesesaré
necessitate	nesesitát
necessity	nesesité
neck	nek
need	neʸd
needle	nédel
needn't	neʸdnt
needy	neʸdé
negate	negát
negation	negásion
negative	negativ
neglect	neglekt
neglectful	neglektfql
negligence	neglijens
negligent	neglijent
negligible	neglijibel
negotiable	negósiabel
negotiate	negósiát
negotiation	negósiásion
negotiator	negósiátor
neighbor	naʸbor
neighborhood	naʸborhqd
neighbour	naʸbor
neighbourhood	naʸborhqd
neither	níðer
nerve	nerv
nervous	nervos
nest	nest
net	net
network	netwurk
neutral	nútral
neutralise	nútralíz
neutrality	nútralité
neutralize	nútralíz
neutron	nútron
never	never
nevertheless	neverðeles
new	nuʷ
newsletter	nuʷzleter
newspaper	nuʷzpáper
next	nekst
nice	niʸs
nicety	niʸseté
niche	nic
nickel	nikel
nicotine	nikotén
night	niʸt
nightmare	niʸtmaʸr
nine	niʸn
nineteen	niʸnteʸn
nineteenth	niʸnteʸnþ
ninety	niʸnté
no	noʷ
nobility	nóbilité
noble	nóbel
nobody	noʷbodé
nod	nod
node	noʷd
nodule	nodúl
noise	noʸz
noisy	noʸzé
nominal	nominal
nominate	nominát
nomination	nominásion
nominee	nominé
none	nun
nonetheless	nunðeles
nonsense	nonsens
noon	nq̇n
nor	nor
norm	norm
normal	normal
normalise	normalíz
normalization	normalizásion
normalize	normalíz
north	norþ
northern	norðern
nose	noʷz
nostril	nostril
not	not
notary	nótaré
notate	nótát
notation	nótásion
note	noʷt
notebook	noʷtbqk
noteworthy	noʷtwurðé
nothing	noþiŋ
notice	nótis
notify	nótifí
notion	nósion
notorious	notórios
novel	novel
novelist	novelist
november	nóvember
now	nqʷ
nowadays	nqʷadaʸz
nowhere	noʷhwaʸr
nuclear	núkléar
nucleus	núkléus
number	number
numeral	númeral
numeric	númerik
numerical	númerikal
numerous	números
nurse	nurs
nursery	nurseré
nut	nut
nutrient	nútrient
nutrition	nútrision
nutritional	nútrisional
nutritionist	nútrisionist
nutritious	nútrisios
obedience	óbédiens
obedient	óbédient
obese	óbés
obesity	óbésité
obey	óbaʸ
object	objekt
objectify	objektifí
objection	objeksion
objective	objektiv
obligate	obligát
obligation	obligásion
obligatory	obligatoré
oblige	oblíj
observance	obzervans
observation	obzervásion
observational	obzervásional
observatory	obzervatoré
observe	obzerv
observer	obzerver
obsess	obses
obsession	obsesion
obsessive	obsesiv
obstacle	obstakel
obtain	obtán
obvious	obvios
occasion	okázion
occasional	okázional
occupation	okúpásion
occupational	okúpásional
occupy	okúpí
occur	okur
occurrence	okurens
ocean	ósian
oceanic	osianik
o'clock	oklok
october	október
odd	od
of	ov
off	of
offence	ofens
offend	ofend
offense	ofens
offensive	ofensiv
offer	ofer
office	ofis
officer	ofiser
official	ofisial
officiate	ofisiát
oft	oft
often	ofen
oftentime	ofentiʸm
oh	ó
oil	oʸl
ok	ókaʸ
old	oʷld
olive	oliv
on	on
once	wuns
one	wun
oneself	wunself
onion	union
online	onliʸn
onlooker	onlqker
only	oʷnlé
onto	ontq̇
open	ópen
opera	opera
operate	operát
operation	operásion
operational	operásional
operative	operativ
operator	operátor
opiate	ópiat
opine	ópín
opinion	opinion
opinionate	opinionát
opioid	ópioʸd
opium	ópium
opponent	opónent
opportunist	oportúnist
opportunistic	oportúnistik
opportunity	oportúnité
oppose	opóz
opposite	opozit
opposition	opozision
opt	opt
optic	optik
optical	optikal
optician	optisian
optimise	optimíz
optimism	optimizem
optimist	optimist
optimistic	optimistik
optimization	optimizásion
optimize	optimíz
option	opsion
optional	opsional
or	or
oral	óral
orange	oranj
orchestra	orkestra
orchestral	orkestral
orchestrate	orkestrát
orchestration	orkestrásion
order	order
ordinary	ordinaré
ore	oʷr
organ	organ
organic	organik
organisation	organizásion
organisational	organizásional
organise	organíz
organism	organizem
organization	organizásion
organizational	organizásional
organize	organíz
organizer	organízer
orient	órient
orientate	orientát
orientation	orientásion
origin	orijin
original	orijinal
originality	orijinalité
originate	orijinát
originator	orijinátor
ornament	ornament
ornamental	ornamental
other	uðer
otherwise	uðerwiʸz
ought	åt
our	qʷr
ours	qʷrz
ourselves	qʷrselvz
out	qʷt
outbreak	qʷtbraʸk
outburst	qʷtburst
outcome	qʷtkum
outcrop	qʷtkrop
outcry	qʷtkriʸ
outdoor	qʷtdoʷr
outer	qʷter
outfit	qʷtfit
outhouse	qʷthqʷs
outlaw	qʷtlå
outlet	qʷtlet
outlier	qʷtliʸer
outline	qʷtliʸn
outlook	qʷtlqk
output	qʷtpqt
outrage	qʷtraʸj
outside	qʷtsiʸd
outsider	qʷtsiʸder
outskirt	qʷtskirt
oval	óval
oven	uven
over	óver
overall	óverål
overwhelm	óverhwelm
owe	oʷ
own	oʷn
ownership	oʷnerxip
oxidation	oksidásion
oxidise	oksídíz
oxidize	oksídíz
oxygen	oksijen
pace	paʸs
pack	pak
package	pakaj
packet	paket
pad	pad
page	paʸj
paid	paʸd
pain	paʸn
painful	paʸnfql
paint	paʸnt
pair	paʸr
palace	palas
pale	paʸl
palm	palm
pan	pan
panel	panel
panellist	panelist
panic	panik
paper	páper
paperback	páperbak
paperclip	páperklip
paperwork	páperwurk
parade	parád
paradise	paradís
paragraph	paragraf
parallel	paralel
parameter	parameter
parcel	parsel
parent	párent
parental	parental
parish	parix
parishioner	parisioner
park	park
parliament	parlament
parliamentarian	parlamentárian
parliamentary	parlamentaré
part	part
partial	parsial
participant	partisipant
participate	partisipát
participation	partisipásion
participator	partisipátor
participatory	partisipatoré
particle	partikel
particular	partikúlar
particularity	partikúlarité
partner	partner
partnership	partnerxip
party	parté
pass	pas
passage	pasaj
passenger	pasenjer
passion	pasion
passionate	pasionat
passive	pasiv
passport	pasport
password	paswurd
past	past
paste	paʸst
pastor	pastor
patch	pac
patent	patent
path	paþ
paths	paðz
pathway	paþwaʸ
patience	pásiens
patient	pásient
patrol	patról
patron	pátron
patronage	pátronaj
patronise	pátroníz
patronize	pátroníz
pattern	patern
pause	påz
pay	paʸ
paycheck	paʸcek
payday	paʸdaʸ
payment	paʸment
peace	peʸs
peaceful	peʸsfql
peacekeep	peʸskeʸp
peacemake	peʸsmaʸk
peacetime	peʸstiʸm
peak	peʸk
peasant	pezant
peculiar	pekúliar
peculiarity	pekúliarité
pedal	pedal
peer	peʸr
peerage	peʸraj
pen	pen
penal	pénal
penalise	penalíz
penalize	penalíz
penalty	penalté
pence	pens
pencil	pensil
pendulum	pendúlum
penguin	peŋgwin
penny	pené
pension	pension
pensioner	pensioner
people	pépel
pepper	peper
per	per
perceive	persév
percentage	persentaj
perception	persepsion
perceptive	perseptiv
perfect	perfekt
perfection	perfeksion
perfectionist	perfeksionist
perform	perform
performance	performans
perhaps	perhaps
period	périod
periodic	périodik
periodical	périodikal
permanence	permanens
permanent	permanent
permissible	permisibel
permission	permision
permissive	permisiv
permit	permit
persist	persist
persistence	persistens
persistent	persistent
person	person
persona	persóna
personal	personal
personalise	personalíz
personality	personalité
personalization	personalizásion
personalize	personalíz
personnel	personel
perspective	perspektiv
persuade	perswád
persuasion	perswázion
persuasive	perswásiv
pet	pet
petal	petal
petition	petision
petrol	petrol
petroleum	petroléum
phase	faʸz
phenomena	fenomena
phenomenal	fenomenal
phenomenon	fenomenon
philosopher	filosofer
philosophical	filosofikal
philosophise	filosofíz
philosophize	filosofíz
philosophy	filosofé
phone	foʷn
photo	fótó
photograph	fótograf
photographer	fotografer
photographic	fótografik
photography	fotografé
phrase	fraʸz
physic	fizik
physical	fizikal
physician	fizisian
physicist	fizisist
physiological	fiziolojikal
physiologist	fiziolojist
physiology	fiziolojé
piano	pianó
pick	pik
picture	piktúr
picturesque	piktúresk
piece	peʸs
pig	pig
pile	piʸl
pill	pil
pilot	pílot
pin	pin
pink	piŋk
pioneer	píonér
pipe	piʸp
pipeline	piʸpliʸn
pirate	pírat
piston	piston
pit	pit
pitch	pic
pity	pité
place	plaʸs
placement	plaʸsment
plain	plaʸn
plan	plan
plane	plaʸn
planet	planet
planetary	planetaré
plant	plant
plantation	plantásion
plaster	plaster
plastic	plastik
plate	plaʸt
platform	platform
platinum	platinum
play	plaʸ
plaything	plaʸþiŋ
plea	pleʸ
plead	pleʸd
pleasant	plezant
please	pleʸz
pleasure	plezúr
pledge	plej
plenty	plenté
plot	plot
plug	plug
plunge	plunj
plus	plus
pocket	poket
poem	póem
poet	póet
poetic	póetik
poetry	póetré
point	poʸnt
poison	poʸzon
poisonous	poʸzonos
pole	poʷl
police	polés
policeman	polésman
policy	polisé
polish	polix
polite	polít
political	politikal
politician	politisian
politicise	politisíz
politicize	politisíz
poll	poʷl
pollen	polen
pollinate	polinát
pollinator	polinátor
pollutant	polútant
pollute	polút
pollution	polúsion
pond	pond
pool	pq̇l
poor	pq̇r
pop	pop
populace	popúlas
popular	popúlar
popularise	popúlaríz
popularity	popúlarité
popularize	popúlaríz
populate	popúlát
population	popúlásion
porcelain	porselan
port	poʷrt
porter	porter
portfolio	portfólió
portion	porsion
portrait	portrat
portray	portraʸ
portrayal	portraʸal
pose	poʷz
position	pozision
positional	pozisional
positive	pozitiv
possess	pozes
possession	pozesion
possessor	pozesor
possibility	posibilité
possible	posibel
post	poʷst
postage	póstaj
postal	póstal
poster	poʷster
postman	poʷstman
postmark	poʷstmark
postpone	póstpón
postponement	póstpónment
pot	pot
potato	potátó
potential	potensial
potentiality	potensialité
pound	pqʷnd
pour	poʷr
poverty	poverté
powder	pq̇der
power	pqʷr
powerful	pqʷrfql
practical	praktikal
practicality	praktikalité
practice	praktis
practise	praktis
practitioner	praktisioner
praise	praʸz
praiseworthy	praʸzwurðé
pray	praʸ
prayer	praʸr
preach	preʸc
precede	preséd
precedence	presedens
precedent	presedent
precious	presios
precise	presís
precision	presízion
predation	predásion
predator	predator
predatory	predatoré
predecessor	predesesor
predict	predikt
prediction	prediksion
predictive	prediktiv
predictor	prediktor
predominant	predominant
prefer	prefer
preference	preferens
preferential	preferensial
pregnancy	pregnansé
pregnant	pregnant
prejudice	prejúdis
prejudicial	prejúdisial
preliminary	preliminaré
premier	premér
premise	premis
premium	prémium
preparation	preparásion
preparatory	preparatoré
prepare	prepár
prescribe	preskríb
prescription	preskripsion
presence	prezens
present	prezent
presentation	prezentásion
preservation	prezervásion
preservative	prezervativ
preserve	prezerv
preside	prezíd
presidency	prezidensé
president	prezident
presidential	prezidensial
press	pres
pressure	presúr
pressurise	presúríz
pressurize	presúríz
prestigious	prestijios
presume	prezúm
pretend	pretend
pretense	prétens
pretension	pretension
pretentious	pretensios
pretty	prité
prevail	prevál
prevalence	prevalens
prevalent	prevalent
prevent	prevent
prevention	prevension
preventive	preventiv
previous	prévios
prey	praʸ
price	priʸs
prick	prik
pride	priʸd
priest	preʸst
primary	prímaré
prime	priʸm
prince	prins
princess	prinses
principal	prinsipal
principality	prinsipalité
principle	prinsipel
print	print
prior	príor
prioritise	príoritíz
prioritize	príoritíz
priority	príorité
prison	prizon
privacy	privasé
private	prívat
privatisation	prívatizásion
privatise	prívatíz
privatization	prívatizásion
privatize	prívatíz
privilege	privilej
prize	priʸz
probability	probabilité
probable	probabel
probe	proʷb
problem	problem
problematic	problematik
problematize	problematíz
procedural	prosédúral
procedure	prosédúr
proceed	proséd
process	próses
processor	prósesor
proclaim	proklám
proclamation	proklamásion
produce	prodús
product	produkt
production	produksion
productive	produktiv
productivity	produktivité
profess	profes
profession	profesion
professional	profesional
professionalism	profesionalizem
professor	profesor
profile	prófíl
profit	profit
profound	prófq́nd
program	prógram
programme	prógram
progress	prógres
progression	progresion
progressive	progresiv
prohibit	próhibit
project	projekt
projectile	projektíl
projection	projeksion
projector	projektor
prominence	prominens
prominent	prominent
promise	promis
promote	promót
promotion	promósion
promotional	promósional
prompt	promt
pronounce	pronq́ns
pronouncement	pronq́nsment
pronunciation	pronunsiásion
proof	prq̇f
propaganda	propaganda
propagandize	propagandíz
proper	proper
property	properté
proportion	proporsion
proportional	proporsional
proportionate	proporsionat
proposal	propózal
propose	propóz
proposition	propozision
prose	proʷz
prosecute	prosekút
prosecution	prosekúsion
prosecutor	prosekútor
prospect	prospekt
prospective	prospektiv
prosper	prosper
prosperity	prosperité
prosperous	prosperos
protect	protekt
protection	proteksion
protective	protektiv
protector	protektor
protein	prótén
protest	prótest
protestant	protestant
protocol	prótokol
proud	prqʷd
prove	prq̇v
proven	prq̇ven
provide	províd
province	provins
provincial	provinsial
provision	provizion
provisional	provizional
provocateur	provokater
provocation	provokásion
provocative	provokativ
provoke	provók
psychiatric	síkiatrik
psychiatrist	síkíatrist
psychiatry	síkíatré
psychological	síkolojikal
psychologist	síkolojist
psychology	síkolojé
pub	pub
public	publik
publication	publikásion
publicise	publisíz
publicist	publisist
publicity	publisité
publicize	publisíz
publish	publix
pull	pql
pulley	pqlé
pulse	puls
pump	pump
punch	punc
punish	punix
punishment	punixment
punk	puŋk
pupil	púpil
purchase	purcas
pure	puʷr
purification	púrifikásion
purify	púrifí
purist	púrist
purity	púrité
purple	purpel
purpose	porpos
purposeful	purposfql
purr	pur
pursuant	pursúant
pursue	pursú
pursuit	pursút
push	pqx
put	pqt
puzzle	puzel
pyramid	piramid
quack	kwak
qualification	kwolifikásion
qualify	kwolifí
qualitative	kwolitátiv
quality	kwolité
quantitative	kwontitátiv
quantity	kwontité
quarter	kworter
queen	kweʸn
query	kwéré
quest	kwest
question	kwestion
questionnaire	kwestionár
queue	kuʷ
quick	kwik
quiet	kwíet
quit	kwit
quite	kwiʸt
quota	kwóta
quotation	kwótásion
quote	kwoʷt
race	raʸs
racial	rásial
racism	raʸsizem
racist	raʸsist
radar	rádar
radiant	rádiant
radiate	rádiát
radiation	rádiásion
radiator	rádiátor
radical	radikal
radicalize	radikalíz
radio	rádió
rage	raʸj
raid	raʸd
rail	raʸl
railway	raʸlwaʸ
rain	raʸn
rainbow	raʸnboʷ
raincoat	raʸnkoʷt
raindrop	raʸndrop
rainfall	raʸnfål
rainforest	raʸnforest
rainstorm	raʸnstorm
rainy	raʸné
raise	raʸz
rally	ralé
ran	ran
random	random
randomise	randomíz
randomize	randomíz
rang	raŋ
range	raʸnj
rank	raŋk
rape	raʸp
rapid	rapid
rare	raʸr
rarity	rárité
rat	rat
rate	raʸt
rather	raðer
ratio	rásio
ration	rasion
rational	rasional
raw	rå
ray	raʸ
reach	reʸc
react	réakt
reactant	réaktant
reaction	réaksion
reactionary	réaksionaré
reactive	réaktiv
reactor	réaktor
read	reʸd
read (past)	red
reader	reʸder
readership	reʸderxip
ready	redé
reagent	réájent
real	réal
realisation	réalizásion
realise	réalíz
realism	réalizem
realist	réalist
realistic	réalistik
reality	réalité
realization	réalizásion
realize	réalíz
realm	relm
rear	reʸr
reason	rézon
reassurance	réaxúrans
reassure	réaxúr
rebel	rebel
rebellion	rebelion
rebellious	rebelios
rebuild	rébild
rebuilt	rébilt
recall	rekål
receipt	resét
receive	resév
recent	résent
reception	resepsion
receptionist	resepsionist
receptive	reseptiv
receptor	reseptor
recession	resesion
recipe	resipé
recipient	resipient
reciprocal	resiprokal
reciprocate	resiprokát
reciprocity	resiprosité
reckon	rekon
recognise	rekogníz
recognition	rekognision
recognize	rekogníz
recollect	rekolekt
recollection	rekoleksion
recommend	rekomend
recommendation	rekomendásion
reconstruct	rékonstrukt
reconstruction	rékonstruksion
record	rekord
recount	rékqʷnt
recount v	rekqʷnt
recover	rekuver
recovery	rekuveré
recruit	rekrút
recruitment	rekrútment
rectangle	rektaŋgel
rectangular	rektaŋgúlar
recycle	resíkel
red	red
reduce	redús
reduction	reduksion
refer	refer
referee	referé
reference	referens
referendum	referendum
referent	referent
referral	referal
reflect	reflekt
reflection	refleksion
reflective	reflektiv
reflector	reflektor
reflux	réfluks
reform	reform
reformation	reformásion
refuge	refúj
refugee	refújé
refusal	refúzal
refuse	refúz
regain	regaʸn
regard	regard
regime	rezjém
region	réjion
regional	réjional
register	rejister
registration	rejistrásion
registry	rejistré
regret	regret
regular	regúlar
regularise	regúlaríz
regularity	regúlarité
regularize	regúlaríz
regulate	regúlát
regulation	regúlásion
regulator	regúlátor
regulatory	regúlatoré
rehabilitate	réhabilitát
rehabilitation	réhabilitásion
reign	raʸn
reinforce	réinfórs
reinforcement	réinfórsment
reject	réjekt
reject v	rejekt
rejection	rejeksion
relate	relát
relation	relásion
relationship	relásionxip
relative	relativ
relax	relaks
relaxation	relaksásion
release	relés
relevance	relevans
relevant	relevant
reliability	relíabilité
reliable	relíabel
relief	reléf
relieve	relév
religion	relijion
religious	relijios
reluctance	reluktans
reluctant	reluktant
rely	relí
remain	remán
remainder	remánder
remark	remark
remedy	remedé
remember	remember
remind	remiʸnd
remote	remót
removal	remq̇val
remove	remq̇v
render	render
renew	renuʷ
renown	renq́n
rent	rent
rental	rental
repair	repár
reparation	reparásion
repeat	repét
replace	replás
replacement	replásment
reply	replí
report	report
represent	reprezent
representation	reprezentásion
representative	reprezentativ
reproduce	réprodús
reproducible	réprodúsibel
reproduction	réproduksion
reproductive	réproduktiv
republic	republik
republican	republikan
reputable	repútabel
reputation	repútásion
repute	repút
request	rekwest
require	rekwír
requirement	rekwírment
requisite	rekwizit
requisition	rekwizision
rescue	reskú
research	réserc
research v	reserc
researcher	resercer
resemblance	rezemblans
resemble	rezembel
reservation	rezervásion
reserve	rezerv
reside	rezíd
residence	rezidens
residency	rezidensé
resident	rezident
residential	rezidensial
residual	rezidúal
residue	rezidú
resign	rezín
resignation	rezignásion
resist	rezist
resistance	rezistans
resistant	rezistant
resolution	rezolúsion
resolve	rezolv
resort	rezort
resource	résórs
resourceful	resórsfql
respect	respekt
respectful	respektfql
respective	respektiv
respond	respond
respondent	respondent
response	respons
responsibility	responsibilité
responsible	responsibel
rest	rest
restaurant	restårant
restoration	restorásion
restore	restór
restrain	restrán
restraint	restránt
restrict	restrikt
restriction	restriksion
restrictive	restriktiv
result	rezult
resultant	rezultant
resume	rezúm
resume 2	rezúmaʸ
resumption	rezumsion
retail	rétál
retain	retán
retention	retension
retire	retír
retirement	retírment
retreat	retrét
retrieval	retréval
retrieve	retrév
return	return
reveal	revél
revelation	revelásion
revenge	revenj
revenue	revenú
reverse	revers
reversible	reversibel
revert	revert
review	revú
revise	revíz
revision	revizion
revisionist	revizionist
revival	revíval
revivalist	revívalist
revive	revív
revolt	revólt
revolution	revolúsion
revolutionary	revolúsionaré
revolutionise	revolúsioníz
revolutionize	revolúsioníz
reward	reword
rhetoric	retorik
rhetorical	retorikal
rhythm	riðem
rhythmic	riðemik
rice	riʸs
rich	ric
rid	rid
ridden	riden
ride	riʸd
ridicule	ridikúl
ridiculous	ridikúlos
rifle	rífel
right	riʸt
rigid	rijid
rigidity	rijidité
ring	riŋ
riot	ríot
rip	rip
rise	riʸz
risen	rizen
risk	risk
risky	riské
ritual	ritúal
rival	ríval
rivalry	rívalré
river	river
road	roʷd
roadie	roʷdé
roadway	roʷdwaʸ
roadwork	roʷdwurk
rob	rob
robbery	roberé
robot	róbot
robotic	róbotik
robust	róbust
rock	rok
rocket	roket
rod	rod
rode	roʷd
role	roʷl
roll	roʷl
romance	rómans
romantic	rómantik
roof	rq̇f
room	rq̇m
root	rq̇t
rope	roʷp
rose	roʷz
rot	rot
rotary	rótaré
rotate	rótát
rotation	rótásion
rough	ruf
roughen	rufen
round	rqʷnd
route	rq̇t
routine	rq̇tén
row	rqʷ
row v	roʷ
royal	roʸal
royalty	roʸalté
rub	rub
rubber	ruber
rubbish	rubix
rude	ruʷd
rugby	rugbé
ruin	rúin
rule	ruʷl
rumor	rúmor
rumour	rúmor
run	run
runaway	runawaʸ
rural	rúral
rush	rux
rust	rust
sac	sak
sack	sak
sacred	sákred
sacrifice	sakrifís
sad	sad
safe	saʸf
safety	saʸfté
said	saʸd
sail	saʸl
sailor	saʸlor
saint	saʸnt
sake	saʸk
salad	salad
salary	salaré
sale	saʸl
salt	solt
same	saʸm
sample	sampel
sanction	saŋksion
sand	sand
sandwich	sandwic
sandy	sandé
sang	saŋ
sank	saŋk
sarcasm	sarkazem
sarcastic	sarkastik
sardine	sardén
satellite	satelít
satisfaction	satisfaksion
satisfactory	satisfaktoré
satisfy	satisfí
saturday	saturdaʸ
sauce	sås
save	saʸv
saw	så
sawn	sån
say	saʸ
scale	skaʸl
scan	skan
scandal	skandal
scandalise	skandalíz
scandalize	skandalíz
scare	skaʸr
scarp	skarp
scary	skaʸré
scenario	senarió
scene	seʸn
scenery	seʸneré
scenic	seʸnik
sceptical	skeptikal
scepticism	skeptisizem
schedule	skedúl
schema	skéma
schematic	skematik
scheme	skeʸm
schist	xist
scholar	skolar
scholarship	skolarxip
scholastic	skolastik
school	skq̇l
schoolbook	skq̇lbqk
science	síens
scientific	síentifik
scientist	síentist
scope	skoʷp
score	skoʷr
scratch	skrac
scream	skreʸm
screen	skreʸn
screw	skruʷ
script	skript
scriptural	skriptúral
scripture	skriptúr
scrutinise	skrútiníz
scrutinize	skrútiníz
scrutiny	skrútiné
sculpt	skulpt
sculptor	skulptor
sculpture	skulptúr
sea	seʸ
seal	seʸl
seaman	seʸman
search	serc
season	sézon
seat	seʸt
second	sekond
secondary	sekondaré
secrecy	sékresé
secret	sékret
secretary	sekretaré
secretion	sekrésion
secretive	sékretiv
section	seksion
sectional	seksional
sector	sektor
secular	sekúlar
secure	sekúr
security	sekúrité
see	seʸ
seed	seʸd
seedling	seʸdliŋ
seek	seʸk
seeker	seʸker
seem	seʸm
seen	seʸn
segment	segment
segmentation	segmentásion
seize	seʸz
seizure	sezúr
seldom	seldom
select	selekt
selection	seleksion
selective	selektiv
selector	selektor
self	self
selfish	selfix
sell	sel
seminar	seminar
seminary	seminaré
senate	senat
senator	senator
send	send
senior	sénior
seniority	seniorité
sensation	sensásion
sensational	sensásional
sense	sens
sensibility	sensibilité
sensible	sensibel
sensitise	sensitíz
sensitive	sensitiv
sensitivity	sensitivité
sensitize	sensitíz
sensor	sensor
sensory	sensoré
sensual	sensúal
sent	sent
sentence	sentens
sentient	sensient
sentiment	sentiment
sentimental	sentimental
separate	separat
separate v	separát
separation	separásion
separatist	separatist
separator	separátor
september	september
sequence	sékwens
sequential	sekwensial
serial	sérial
series	séréz
serious	sérios
serum	sérum
servant	servant
serve	serv
service	servis
session	sesion
set	set
settle	setel
settlement	setelment
seven	seven
seventeen	seventeʸn
seventeenth	seventeʸnþ
seventh	sevenþ
seventy	seventé
several	several
severe	sevér
sewn	soʷn
sex	seks
sexual	seksúal
sexuality	seksúalité
sexy	seksé
shade	xaʸd
shadow	xadó
shadowy	xadóé
shake	xaʸk
shaken	xaʸken
shaky	xaʸké
shale	xaʸl
shall	xal
shallow	xaló
shalt	xalt
shame	xaʸm
shameful	xaʸmfql
shan't	xant
shape	xaʸp
share	xaʸr
shareholder	xaʸrhoʷlder
sharp	xarp
shatter	xater
shave	xaʸv
she	xeʸ
shear	xeʸr
shed	xed
she'd	xeʸd
sheep	xeʸp
sheer	xeʸr
sheet	xeʸt
shelf	xelf
shell	xel
she'll	xeʸl
shelter	xelter
she's	xeʸz
shift	xift
shine	xiʸn
shiny	xiʸné
ship	xip
shirt	xirt
shock	xok
shoe	xuʷ
shone	xon
shook	xqk
shoot	xuʷt
shop	xop
shore	xoʷr
short	xort
shortage	xortaj
shorthand	xorthand
shot	xot
should	xqd
shoulder	xólder
shouldn't	xqdnt
shout	xqʷt
show	xoʷ
shower	xqʷr
shown	xoʷn
shrank	xraŋk
shrink	xriŋk
shrug	xrug
shrunk	xruŋk
shut	xut
shy	xiʸ
sibling	sibliŋ
sick	sik
side	siʸd
sideboard	siʸdboʷrd
sidewalk	siʸdwåk
sigh	siʸ
sight	siʸt
sightsee	siʸtseʸ
sign	siʸn
signage	siʸnaj
signal	signal
signature	signatúr
significance	signifikans
significant	signifikant
signification	signifikásion
signify	signifí
silence	sílens
silent	sílent
silk	silk
sill	sil
silly	silé
silver	silver
similar	similar
similarity	similarité
simple	simpel
simplicity	simplisité
simplification	simplifikásion
simplify	simplifí
simplistic	simplistik
simulate	simúlát
simulation	simúlásion
simulator	simúlátor
simultaneous	simultánéos
sin	sin
since	sins
sincere	sinsér
sing	siŋ
singer	siŋer
single	siŋgel
sink	siŋk
sir	sir
sister	sister
sit	sit
site	siʸt
situate	sitúát
situation	sitúásion
situational	sitúásional
six	siks
sixteen	siksteʸn
sixteenth	siksteʸnþ
sixth	siksþ
sixty	siksté
size	siʸz
skeptical	skeptikal
skepticism	skeptisizem
sketch	skec
ski	skeʸ
skill	skil
skin	skin
skinny	skiné
skip	skip
skirt	skirt
skull	skul
sky	skiʸ
slam	slam
slap	slap
slash	slax
slate	slaʸt
slave	slaʸv
slavery	sláveré
sleep	sleʸp
sleeve	sleʸv
slept	slept
slice	sliʸs
slid	slid
slide	sliʸd
slight	sliʸt
slip	slip
slippery	sliperé
slogan	slógan
slope	sloʷp
slot	slot
slow	sloʷ
small	smål
smart	smart
smash	smax
smell	smel
smelly	smelé
smile	smiʸl
smoke	smoʷk
smoky	smoʷké
smooth	smq̇ð
smoothie	smq̇ðé
snake	snaʸk
snap	snap
sneeze	sneʸz
snow	snoʷ
snowball	snoʷbål
snowfall	snoʷfål
snowflake	snoʷflaʸk
snowman	snoʷman
snowstorm	snoʷstorm
so	soʷ
soak	soʷk
soap	snoʷp
soar	soʷr
soccer	soker
social	sósial
socialise	sósialíz
socialism	sósializem
socialist	sósialist
socialite	sósialít
socialization	sósializásion
socialize	sósialíz
societal	sosíetal
society	sosíeté
sock	sok
soft	soft
soften	sofen
software	softwaʸr
soil	soʸl
solar	sólar
sold	soʷld
soldier	sóldier
sole	soʷl
solicit	solisit
solicitation	solisitásion
solicitor	solisitor
solid	solid
solidarity	solidarité
solidify	solidifí
solo	sóló
soloist	sólóist
solution	solúsion
solve	solv
solvency	solvensé
solvent	solvent
some	sum
somebody	sumbodé
someday	sumdaʸ
somehow	sumhqʷ
someone	sumwun
someplace	sumplaʸs
something	sumþiŋ
sometime	sumtiʸm
somewhat	sumhwot
somewhere	sumhwaʸr
son	sun
song	soŋ
soon	sq̇n
sophisticate	sofistikát
sophistication	sofistikásion
sorrow	soró
sorry	soré
sort	sort
soul	soʷl
sound	sqʷnd
soup	sq̇p
source	soʷrs
south	sqʷþ
southern	suðern
sovereign	soveran
sovereignty	soveranté
sow	soʷ
sow 2	sqʷ
sown	soʷn
space	spaʸs
spade	spaʸd
spam	spam
span	span
spare	spaʸr
spark	spark
speak	speʸk
special	spesial
specialisation	spesializásion
specialise	spesialíz
specialist	spesialist
speciality	spesialité
specialization	spesializásion
specialize	spesialíz
specialty	spesialté
species	spéséz
specific	spesifik
specification	spesifikásion
specificity	spesifisité
specify	spesifí
specimen	spesimen
spectacle	spektakel
spectacular	spektakúlar
spectator	spektátor
spectrum	spektrum
speculate	spekúlát
speculation	spekúlásion
speculative	spekúlativ
speculator	spekúlátor
speech	speʸc
speed	speʸd
spell	spel
spelt	spelt
spend	spend
spent	spent
sphere	sfeʸr
spice	spiʸs
spicy	spiʸsé
spider	spíder
spill	spil
spillage	spilaj
spilt	spilt
spin	spin
spine	spiʸn
spirit	spirit
spiritual	spiritúal
spirituality	spiritúalité
spit	spit
spite	spiʸt
splash	splax
split	split
spoil	spoʸl
spoken	spoʷken
spokesman	spoʷksman
spokesperson	spoʷksperson
spokeswoman	spoʷkswqman
sponge	spunj
sponsor	sponsor
sponsorship	sponsorxip
spoon	spq̇n
spoonful	spq̇nfql
sport	spoʷrt
spot	spot
spotlight	spotliʸt
spouse	spqʷs
spread	spred
spring	spriŋ
spy	spiʸ
squad	skwod
square	skwaʸr
squeeze	skweʸz
stab	stab
stabilise	stábilíz
stability	stabilité
stabilization	stábilizásion
stabilize	stábilíz
stable	stábel
stadium	stádium
staff	staf
stage	staʸj
stain	staʸn
stair	staʸr
staircase	staʸrkaʸs
stake	staʸk
stalk	ståk
stall	stål
stamen	stámen
stamp	stamp
stance	stans
stand	stand
standard	standard
standardise	standardíz
standardization	standardizásion
standardize	standardíz
stank	staŋk
star	star
stare	staʸr
stark	stark
start	start
starvation	starvásion
starve	starv
state	staʸt
statement	staʸtment
static	statik
station	stásion
stationary	stásionaré
statistic	statistik
statistical	statistikal
statistician	statistisian
statue	statú
status	status
stay	staʸ
steady	stedé
steal	steʸl
stealth	stelþ
steam	steʸm
steel	steʸl
steep	steʸp
steer	steʸr
stem	stem
step	step
stereotype	steréótíp
stereotypical	steréótipikal
stick	stik
sticky	stiké
stiff	stif
stiffen	stifen
still	stil
stimulant	stilmúlant
stimulate	stimúlát
stimulation	stimúlásion
stimulus	stimúlus
stink	stiŋk
stir	stir
stitch	stic
stock	stok
stole	stoʷl
stolen	stoʷlen
stomach	stumak
stone	stoʷn
stood	stqd
stop	stop
storage	stoʷraj
store	stoʷr
storm	storm
story	stóré
straight	straʸt
straighten	straʸten
straightforward	straʸtforword
strain	straʸn
strand	strand
strange	straʸnj
strategic	stratéjik
strategist	stratejist
strategy	stratejé
straw	strå
strawberry	stråberé
stream	streʸm
street	streʸt
strength	streŋþ
strengthen	streŋþen
stress	stres
stretch	strec
strict	strikt
strike	striʸk
string	striŋ
strip	strip
strive	striʸv
stroke	stroʷk
strong	stroŋ
struck	struk
structural	struktúral
structure	struktúr
struggle	strugel
stuck	stuk
student	stúdent
studio	stúdió
study	studé
stuff	stuf
stumble	stumbel
stun	stun
stung	stuŋ
stunk	stuŋk
stupid	stúpid
style	stiʸl
subject	subjekt
subjective	subjektiv
subjectivity	subjektivité
submission	submision
submissive	submisiv
submit	submit
subscribe	subskríb
subscription	subskripsion
subsequent	subsekwent
subsidiary	subsidiaré
subsidise	subsidíz
subsidize	subsidíz
subsidy	subsidé
substance	substans
substantial	substansial
substantiate	substansiát
substitute	substitút
substitution	substitúsion
subtle	sutel
subtlety	sutelté
subtraction	subtraksion
suburb	suburb
suburban	suburban
suburbanite	suburbanít
succeed	sukséd
success	sukses
successful	suksesfql
succession	suksesion
successive	suksesiv
successor	suksesor
such	suc
suck	suk
sudden	suden
sue	suʷ
suffer	sufer
suffice	sufís
sufficient	sufisient
sugar	xqgar
sugary	xqgaré
suggest	sujest
suggestion	sujestion
suggestive	sujestiv
suicidal	súisídal
suicide	súisíd
suit	suʷt
suite	sweʸt
sum	sum
summarize	sumaríz
summary	sumaré
summer	sumer
summit	sumit
sun	sun
sunday	sundaʸ
sung	suŋ
sunk	suŋk
sunken	suŋken
sunlight	sunliʸt
super	súper
superb	súperb
superior	súpérior
supermarket	súpermarket
supervise	súpervíz
supervision	súpervizion
supervisor	súpervízor
supplement	suplement
supplemental	suplemental
supplementary	suplementaré
supply	suplí
support	suport
supportive	suportiv
suppose	supóz
supposition	supozision
suppress	supres
suppression	supresion
supremacy	súpremasé
supreme	súpréme
sure	xuʷr
surface	surfas
surge	surj
surgeon	surjon
surgery	surjeré
surgical	surjikal
surplus	surplus
surprise	surpríz
surrender	surender
surround	surq̇nd
surveillance	surválans
survey	survaʸ
surveyor	survaʸor
survival	survíval
survive	survív
survivor	survívor
suspect	suspekt
suspend	suspend
suspense	suspens
suspension	suspension
suspicion	suspision
suspicious	suspisios
sustain	sustán
swallow	swoló
swam	swam
swear	swaʸr
sweat	swet
sweep	sweʸp
sweet	sweʸt
sweetheart	sweʸthart
swept	swept
swim	swim
swing	swiŋ
switch	swic
swole	swoʷl
swollen	swoʷlen
sword	soʷrd
swore	swoʷr
sworn	swoʷrn
swum	swum
swung	swuŋ
symbol	simbol
symbolic	simbolik
symbolise	simbolíz
symbolism	symbolizem
symbolize	simbolíz
sympathetic	simpaþetik
sympathise	simpaþíz
sympathize	simpaþíz
sympathy	simpaþé
symptom	simtom
syndrome	sindróm
synthesis	sinþesis
synthesise	sinþesíz
synthesize	sinþesíz
synthetic	sinþetik
system	sistem
systematic	sistematik
systemic	sistemik
table	tábel
tableau	tabló
tablet	tablet
tackle	takel
tactic	taktik
tactical	taktikal
tag	tag
tail	taʸl
tailor	taʸlor
take	taʸk
taken	taʸken
tale	taʸl
talent	talent
talk	tåk
tall	tål
tame	taʸm
tank	taŋk
tap	tap
tape	taʸp
target	target
task	task
taste	taʸst
taught	tåt
tax	taks
taxation	taksásion
taxi	taksé
taxpayer	takspaʸer
tea	teʸ
teabag	teʸbag
teach	teʸc
teacup	teʸkup
team	teʸm
teammate	teʸmmaʸt
teamwork	teʸmwurk
tear	taʸr
tear 2	teʸr
technical	teknikal
technicality	teknikalité
technician	teknision
technique	teknék
technological	teknolojikal
technology	teknolojé
teenage	teʸnaʸj
teeth	teʸþ
telegram	telegram
telephone	telefón
television	televizion
tell	tel
temperate	temperat
temperature	temperatúr
temple	tempel
temporary	temporaré
tempt	temt
temptation	temtásion
ten	ten
tenant	tenant
tend	tend
tendency	tendensé
tender	tender
tennis	tenis
tension	tension
tent	tent
tenth	tenþ
tenure	tenúr
term	term
terminal	terminal
terminate	terminát
termination	terminásion
terminator	terminátor
terrace	teras
terrain	terán
terrible	teribel
terrific	terifik
terrify	terifí
territory	teritoré
terror	teror
terrorism	terorizem
terrorist	terorist
test	test
testify	testifí
testimony	testimóné
text	tekst
textbook	tekstbqk
texture	tekstúr
than	ðan
thank	þaŋk
that	ðat
the	ðe
theater	þéater
theatre	þéater
theatrical	þéatrikal
thee	ðeʸ
theft	þeft
their	ðaʸr
theirs	ðaʸrz
them	ðem
thematic	þématik
theme	þeʸm
themselves	ðemselvz
then	ðen
theological	þéolojikal
theology	þéolojé
theoretical	þéoretikal
theorise	þéoríz
theorist	þéorist
theorize	þéoríz
theory	þéoré
therapist	þerapist
therapy	þerapé
there	ðaʸr
thereafter	ðaʸrafter
thereby	ðaʸrbiʸ
therefore	ðaʸrfoʷr
thermometer	þermometer
these	ðeʸz
thesis	þésis
they	ðaʸ
they'd	ðaʸd
they'll	ðaʸl
they're	ðaʸr
they've	ðaʸv
thick	þik
thief	þeʸf
thieve	þeʸv
thin	þin
thing	þiŋ
think	þiŋk
third	þird
thirst	þirst
thirsty	þirsté
thirteen	þirteʸn
thirteenth	þirteʸnþ
thirty	þirté
this	ðis
thorough	þuró
those	ðoʷz
though	ðoʷ
thought	þåt
thoughtful	þåtfql
thousand	þq́zand
thread	þred
threat	þret
threaten	þreten
three	þreʸ
threshold	þrexhoʷld
threw	þruʷ
thrive	þriʸv
throat	þroʷt
through	þrq̇
throughout	þrq̇qʷt
throw	þroʷ
thrown	þroʷn
thrust	þrust
thumb	þum
thunder	þunder
thursday	þurzdaʸ
thus	ðus
ticket	tiket
tide	tiʸd
tidy	tiʸdé
tie	tiʸ
tight	tiʸt
tighten	tiʸten
till	til
timber	timber
time	tiʸm
tin	tin
tiny	tiʸné
tip	tip
tire	tiʸr
tissue	tisú
title	títel
to	tq̇
toast	toʷst
tobacco	tobakó
today	tq̇daʸ
toe	toʷ
together	tq̇geðer
toilet	toʸlet
told	toʷld
tolerable	tolerabel
tolerance	tolerans
tolerant	tolerant
tolerate	tolerát
toll	toʷl
tomato	tomátó
tomorrow	tq̇moró
ton	tun
tone	toʷn
tongue	tuŋ
tonight	tq̇niʸt
tonnage	tunaj
tonne	tun
too	tq̇
took	tqk
tool	tq̇l
tooth	tq̇þ
toothbrush	tq̇þbrux
toothpaste	tq̇þpaʸst
top	top
topic	topik
topical	topikal
tore	toʷr
torn	toʷrn
torpedo	torpédó
torture	tortúr
toss	tos
total	tótal
totality	tótalité
touch	tuc
tough	tuf
toughen	tufen
tour	tq̇r
tourism	tq̇rizem
tourist	tq̇rist
tournament	tq̇rnament
toward	tq̇word
towel	tqʷel
tower	tqʷr
town	tqʷn
toxic	toksik
toxicity	toksisité
toxicology	toksikolojé
toxin	toksin
toy	toʸ
trace	traʸs
track	trak
trade	traʸd
trademark	traʸdmark
tradesman	traʸdzman
tradition	tradision
traditional	tradisional
traditionalist	tradisionalist
traffic	trafik
tragedy	trajedé
tragic	trajik
trail	traʸl
trailer	traʸler
train	traʸn
trainer	traʸner
trait	traʸt
transact	tranzakt
transaction	tranzaksion
transactional	tranzaksional
transcribe	transkríb
transcript	transkript
transcription	transkripsion
transfer	transfer
transform	transform
transformation	transformásion
transformational	tranzformásional
transformative	tranzformativ
transit	tranzit
transition	tranzision
transitional	tranzisional
translate	tranzlát
translation	tranzlásion
translator	tranzlátor
transmission	tranzmision
transmit	tranzmit
transparency	transparensé
transparent	tranzparent
transport	transport
transportation	tranzportásion
trap	trap
trauma	tråma
traumatic	tråmatik
traumatise	tråmatíz
traumatize	tråmatíz
travel	travel
tray	traʸ
treasure	trezúr
treasury	trezúré
treat	treʸt
treatment	treʸtment
treaty	trété
tree	treʸ
tremendous	tremendos
trend	trend
trendy	trendé
trial	tríal
triangle	tríaŋgel
triangular	tríaŋgúlar
tribal	tríbal
tribe	triʸb
tribunal	tribúnal
tribune	tribún
tributary	tribútaré
tribute	tribút
trick	trik
tricky	triké
trigger	triger
trillion	trilion
trio	trió
trip	trip
triumph	tríumf
triumphant	tríumfant
troop	trq̇p
trophy	trófé
tropic	tropik
tropical	tropikal
trouble	trubel
trouser	trqʷzer
truck	truk
true	truʷ
trust	trust
trustee	trusté
trustworthy	trustwurðé
truth	truʷþ
truthful	truʷþfql
try	triʸ
tsunami	sq̇namé
tube	tuʷb
tuesday	túzdaʸ
tuition	túision
tune	tuʷn
tunnel	tunel
turbine	turbín
turn	turn
turnout	turnqʷt
turnover	turnóver
twelfth	twelfþ
twelve	twelv
twentieth	twentéeþ
twenty	twenté
twice	twiʸs
twin	twin
twist	twist
two	tq̇
type	tiʸp
typical	tipikal
typist	tiʸpist
tyre	tiʸr
ugly	uglé
ultimate	ultimat
umbrella	umbrela
uncle	uŋkel
under	under
understand	understand
understood	understqd
uniform	úniform
unify	únifí
union	únion
unique	únék
unit	únit
unite	únít
unity	únité
universal	úniversal
universality	úniversalité
universe	únivers
university	úniversité
unless	unles
until	until
up	up
update	updaʸt
upgrade	upgraʸd
uphold	uphoʷld
uplift	uplift
upon	upon
upper	uper
upright	upriʸt
uproot	uprq̇t
upset	upset
upstairs	upstaʸrz
uptake	uptaʸk
upward	upword
urban	urban
urbanise	urbaníz
urbanization	urbanizásion
urbanize	urbaníz
urge	urj
urgency	urjensé
urgent	urjent
us	us
usage	uʷsaj
use	uʷs
use v	uʷz
useful	uʷsfql
useless	uʷsles
user	uʷzer
usual	úsúal
utilise	útilíz
utilitarian	útilitarian
utility	útilité
utilization	útilizásion
utilize	útilíz
vacancy	vákansé
vacant	vákant
vacate	vákát
vacation	vákásion
vacuum	vakúm
vague	vaʸg
valency	válensé
valid	valid
validate	validát
validation	validásion
validity	validité
valley	valé
valuable	valúabel
valuation	valúásion
value	valú
valve	valv
van	van
vanilla	vanila
vanish	vanix
vapor	vápor
variability	variabilité
variable	váriabel
variance	várians
variant	váriant
variation	váriásion
variety	varíeté
various	varios
vary	váré
vascular	vaskúlar
vast	vast
vegetable	vejetabel
vegetarian	vejetárian
vegetate	vejetát
vegetation	vejetásion
vegetative	vejetátiv
vehicle	véhikel
vein	vaʸn
velocity	velosité
venture	ventúr
venue	venú
verbal	verbal
verbalise	verbalíz
verbalize	verbalíz
verdict	verdikt
verification	verifikásion
verify	verifí
verse	vers
version	verzion
versus	versuz
vertical	vertikal
very	veré
vessel	vesel
veteran	veteran
via	vía
viability	víabilité
viable	víabel
vibrant	víbrant
vibrate	víbrát
vibration	víbrásion
vibrator	víbrátor
vice	viʸs
vicious	visios
victim	viktim
victimise	viktimíz
victimization	viktimizásion
victimize	viktimíz
victor	viktor
victory	viktoré
video	vidéó
view	vuʷ
viewer	vuʷer
viewpoint	vuʷpoʸnt
village	vilaj
violate	víolát
violation	víolásion
violator	víolátor
violence	víolens
violent	víolent
violin	víolin
violinist	víolinist
virtual	virtúal
virtue	virtú
virus	vírus
visa	véza
visible	vizibel
vision	vizion
visit	vizit
visitor	vizitor
visual	vizúal
visualise	vizúalíz
visualization	vizúalizásion
visualize	vizúalíz
vital	vítal
vitamin	vitamin
vocabulary	vokabúlaré
vocal	vókal
vocalisation	vókalizásion
vocalise	vókalíz
vocalist	vókalist
vocalize	vókalíz
vodka	vodka
voice	voʸs
volt	voʷlt
voltage	voʷltaj
volume	volúm
voluntary	voluntaré
volunteer	voluntér
vortex	vorteks
vote	voʷt
vow	vqʷ
vulnerability	vulnerabilité
vulnerable	vulnerabel
wage	waʸj
wait	waʸt
wake	waʸk
walk	wåk
wall	wål
wander	wonder
want	wont
war	wor
ward	word
warehouse	waʸrhqʷs
warfare	worfaʸr
warm	worm
warn	worn
warrant	worant
warrior	worior
was	woz
wash	wox
wasn't	woznt
waste	waʸst
wasteful	waʸstfql
watch	woc
watchdog	wocdog
watchful	wocfql
water	wåter
waterfall	wåterfål
wave	waʸv
wavelength	waʸvleŋþ
wax	waks
way	waʸ
we	weʸ
weak	weʸk
weaken	weʸken
weakling	weʸkliŋ
wealth	welþ
wealthy	welþé
weapon	wepon
weaponry	weponré
wear	waʸr
weather	weðer
weatherman	weðerman
weave	weʸv
web	web
website	websiʸt
we'd	weʸd
wedge	wej
wednesday	wenzdaʸ
weed	weʸd
week	weʸk
weekday	weʸkdaʸ
weekend	weʸkend
weekly	weʸklé
weigh	waʸ
weight	waʸt
weightlift	waʸtlift
weighty	waʸté
weird	weʸrd
weirdo	weʸrdó
welcome	welkum
welfare	welfaʸr
well	wel
we'll	weʸl
went	went
wept	wept
were	wer
we're	weʸr
weren't	wernt
west	west
western	western
wet	wet
we've	weʸv
what	hwot
whatever	hwotever
whatsoever	hwotsoʷever
wheat	hweʸt
wheel	hweʸl
when	hwen
whence	hwens
whenever	hwenever
where	hwaʸr
whereabout	hwaʸrabqʷt
whereas	hwaʸraz
whereby	hwaʸrbiʸ
wherefore	hwaʸrfoʷr
wherein	hwaʸrin
wherever	hwaʸrever
whether	hweðer
which	hwic
whichever	hwicever
while	hwiʸl
whilst	hwiʸlst
whip	hwip
whiskey	hwiské
whisky	hwiské
whisper	hwisper
whistle	hwisel
whistleblow	hwiselbloʷ
white	hwiʸt
whitewash	hwiʸtwox
who	hq̇
whoever	hq̇ever
whole	hoʷl
wholeheart	hoʷlhart
wholesale	hoʷlsaʸl
wholesome	hoʷlsum
whom	hq̇m
whomever	hq̇mever
whose	hq̇z
whosoever	hq̇soʷever
why	hwiʸ
wide	wiʸd
widen	wiʸden
widespread	wiʸdspred
widow	widó
width	widþ
wife	wiʸf
wild	wiʸld
wildlife	wiʸldliʸf
will	wil
win	win
wind	wind
wind 2	wiʸnd
window	windó
windy	windé
windy 2	wiʸndé
wine	wiʸn
winemake	wiʸnmaʸk
winery	wiʸneré
wing	wiŋ
winter	winter
wipe	wiʸp
wire	wiʸr
wisdom	wizdom
wise	wiʸz
wish	wix
wishful	wixfql
wit	wit
with	wiþ
withdraw	wiþdrå
withdrawal	wiþdråal
within	wiðin
without	wiðqʷt
witness	witnes
woke	woʷk
woken	woʷken
woman	wqman
womanise	wqmaníz
womanize	wqmaníz
women	wimen
won	wun
wonder	wunder
wonderful	wunderfql
won't	woʷnt
wood	wqd
wooden	wqden
woodwork	wqdwurk
woody	wqdé
wool	wql
woollen	wqlen
woolly	wqlé
word	wurd
wore	woʷr
work	wurk
workday	wurkdaʸ
workforce	wurkfoʷrs
workhouse	wurkhqʷs
workman	wurkman
workmanship	wurkmanxip
workout	wurkqʷt
workplace	wurkplaʸs
workshop	wurkxop
world	wurld
worldview	wurldvuʷ
worldwide	wurldwiʸd
worm	wurm
worn	woʷrn
worrisome	wurésum
worry	wuré
worse	wurs
worsen	wursen
worship	wurxip
worst	wurst
worth	wurþ
worthwhile	wurþhwiʸl
worthy	wurðé
would	wqd
wouldn't	wqdnt
wound	wq̇nd
wound (past)	wqʷnd
wow	woʷ
wrap	rap
wreck	rek
wreckage	rekaj
wrist	rist
write	riʸt
written	riten
wrong	roŋ
wrote	roʷt
wrought	råt
yard	yard
yawn	yån
yeah	ya
year	yeʸr
yearbook	yeʸrbqk
yell	yel
yellow	yeló
yes	yes
yesterday	yesterdaʸ
yet	yet
yield	yeʸld
you	uʷ
you'd	uʷd
you'll	uʷl
young	yuŋ
younger	yuŋger
youngster	yuŋster
your	uʷr
you're	uʷr
yours	uʷrz
yourself	uʷrself
yourselves	uʷrselvz
youth	uʷþ
youthful	uʷþfql
you've	uʷv
zebra	zebra
zero	zéró
zinc	ziŋk
zone	zoʷn
zoological	zóolojikal
zoologist	zóolojist
zoology	zóolojé